Geographic Area Name,Estimate!!Total:,Margin of Error!!Total:,Estimate!!Total:!!Under 19 years:,Margin of Error!!Total:!!Under 19 years:,Estimate!!Total:!!Under 19 years:!!With health insurance coverage,Margin of Error!!Total:!!Under 19 years:!!With health insurance coverage,Estimate!!Total:!!Under 19 years:!!No health insurance coverage,Margin of Error!!Total:!!Under 19 years:!!No health insurance coverage,Estimate!!Total:!!19 to 64 years:,Margin of Error!!Total:!!19 to 64 years:,Estimate!!Total:!!19 to 64 years:!!With health insurance coverage,Margin of Error!!Total:!!19 to 64 years:!!With health insurance coverage,Estimate!!Total:!!19 to 64 years:!!No health insurance coverage,Margin of Error!!Total:!!19 to 64 years:!!No health insurance coverage,Estimate!!Total:!!65 years and over:,Margin of Error!!Total:!!65 years and over:,Estimate!!Total:!!65 years and over:!!With health insurance coverage,Margin of Error!!Total:!!65 years and over:!!With health insurance coverage,Estimate!!Total:!!65 years and over:!!No health insurance coverage,Margin of Error!!Total:!!65 years and over:!!No health insurance coverage
"Autauga County, Alabama",56855,1194,14580,770,14169,743,411,333,33031,1375,29728,1781,3303,1317,9244,499,9184,517,60,102
"Baldwin County, Alabama",235756,2108,52496,1056,49496,1488,3000,1270,132966,2158,115945,3431,17021,2775,50294,1384,49522,1018,772,1034
"Barbour County, Alabama",21787,946,5563,427,5548,445,15,38,11783,972,10368,1069,1415,651,4441,449,4441,449,0,216
"Bibb County, Alabama",21544,1444,4365,754,4232,777,133,211,13170,1440,11940,1346,1230,711,4009,1106,4009,1106,0,216
"Blount County, Alabama",58690,266,14112,389,13838,488,274,248,34088,487,28940,1262,5148,1233,10490,270,10490,270,0,216
"Butler County, Alabama",19109,1469,4448,810,4202,784,246,290,11065,1108,9082,1148,1983,742,3596,488,3596,488,0,216
"Calhoun County, Alabama",114601,1298,26964,716,25454,967,1510,819,66964,1393,53809,2868,13155,2508,20673,328,20410,404,263,254
"Chambers County, Alabama",34256,256,7849,693,7302,1069,547,779,19093,820,15649,1544,3444,1316,7314,463,7314,463,0,216
"Cherokee County, Alabama",25098,2447,4211,1257,4145,1241,66,82,15265,1825,13171,1813,2094,809,5622,799,5622,799,0,216
"Chilton County, Alabama",44827,678,10850,608,10449,734,401,544,26866,874,22737,1220,4129,1139,7111,331,7111,331,0,216
"Clarke County, Alabama",20018,2649,4455,1052,4368,1088,87,109,11561,1765,10184,1523,1377,639,4002,725,4002,725,0,216
"Coffee County, Alabama",51875,809,13481,372,12387,559,1094,673,29521,1033,25343,1126,4178,906,8873,547,8833,551,40,56
"Colbert County, Alabama",57180,156,12747,545,12452,590,295,267,32656,810,29494,1235,3162,1054,11777,623,11777,623,0,216
"Covington County, Alabama",37134,258,8831,427,7773,838,1058,689,20622,641,16850,1291,3772,948,7681,491,7681,491,0,216
"Cullman County, Alabama",89194,371,20531,488,19793,603,738,569,52063,566,45514,1689,6549,1624,16600,417,16474,380,126,201
"Dale County, Alabama",46046,1037,12047,781,11938,783,109,164,25410,1188,22495,1143,2915,774,8589,622,8589,622,0,216
"Dallas County, Alabama",37353,265,9697,658,9334,833,363,297,20427,605,17472,1090,2955,938,7229,219,7229,219,0,216
"DeKalb County, Alabama",71080,508,18099,599,16825,1177,1274,1100,40881,674,28912,1799,11969,1875,12100,488,11970,419,130,175
"Elmore County, Alabama",84444,1664,20260,321,19284,793,976,615,49719,1727,38098,3250,11621,2767,14465,620,14465,620,0,216
"Escambia County, Alabama",35593,712,8396,1077,7942,1130,454,432,20143,1262,16812,1604,3331,1222,7054,492,7048,495,6,13
"Etowah County, Alabama",102521,261,23528,453,22172,1561,1356,1419,59747,433,48222,2029,11525,2010,19246,262,18926,531,320,473
"Franklin County, Alabama",31817,120,9631,994,8104,726,1527,1080,16974,1011,14093,836,2881,1255,5212,266,5212,266,0,216
"Geneva County, Alabama",25460,2444,6136,1253,5696,1228,440,396,13916,1599,11408,1565,2508,879,5408,757,5408,757,0,216
"Houston County, Alabama",106536,443,25531,361,24779,431,752,309,61472,391,50427,1227,11045,1200,19533,325,19494,326,39,63
"Jackson County, Alabama",52313,421,11974,827,10856,880,1118,642,29443,713,23748,1617,5695,1612,10896,533,10896,533,0,216
"Jefferson County, Alabama",661543,1406,160668,1331,154618,2396,6050,2221,392948,1882,340692,4479,52256,4534,107927,871,107411,968,516,527
"Lauderdale County, Alabama",93063,798,19702,489,19010,744,692,578,54837,1076,44226,2240,10611,2152,18524,337,18524,337,0,216
"Lawrence County, Alabama",32876,314,7312,67,7237,130,75,116,19851,382,16470,1290,3381,1143,5713,364,5713,364,0,216
"Lee County, Alabama",176109,746,40802,1136,39351,1506,1451,1144,112613,1284,93874,4578,18739,4828,22694,418,22308,604,386,421
"Limestone County, Alabama",104349,783,25194,861,24937,900,257,289,62557,1400,53054,2798,9503,2874,16598,947,16598,947,0,216
"Macon County, Alabama",21115,1504,5007,899,4368,847,639,761,12568,1163,10521,1267,2047,689,3540,581,3507,583,33,54
"Madison County, Alabama",388653,1350,90785,1359,85889,2772,4896,2199,237143,1900,212934,4189,24209,4154,60725,653,60459,701,266,258
"Marion County, Alabama",28748,348,5803,648,5736,633,67,91,17199,690,13150,1644,4049,1476,5746,170,5746,170,0,216
"Marshall County, Alabama",97151,666,25961,239,25323,411,638,333,55025,612,43193,2360,11832,2244,16165,348,15909,475,256,347
"Mobile County, Alabama",409181,946,101395,920,97196,1847,4199,1705,238834,1417,191812,5475,47022,5095,68952,844,68667,864,285,274
"Monroe County, Alabama",20519,1613,4784,1198,4577,1225,207,157,10893,1048,9008,1069,1885,761,4842,695,4842,695,0,216
"Montgomery County, Alabama",221755,1819,57672,808,55004,1601,2668,1555,128614,1851,107033,3193,21581,3055,35469,678,34750,864,719,633
"Morgan County, Alabama",121663,967,30186,744,29066,1060,1120,821,69389,1084,57010,2324,12379,2275,22088,678,22088,678,0,216
"Pickens County, Alabama",17495,2018,4294,779,4265,779,29,52,9114,1430,8180,1402,934,408,4087,691,4087,691,0,216
"Pike County, Alabama",32839,300,7682,644,7235,723,447,352,20099,625,17690,1006,2409,763,5058,324,5058,324,0,216
"Randolph County, Alabama",21787,203,5151,756,4846,766,305,321,13811,887,11535,1122,2276,806,2825,713,2767,717,58,93
"Russell County, Alabama",55716,1105,14750,909,14619,900,131,208,32477,1426,27022,2218,5455,2135,8489,185,8291,415,198,357
"St. Clair County, Alabama",90715,800,21828,862,21508,882,320,397,52669,1193,45508,2570,7161,2400,16218,601,16152,626,66,111
"Shelby County, Alabama",224674,999,55124,923,53618,1113,1506,870,132887,1274,121517,2051,11370,1700,36663,519,36663,519,0,216
"Talladega County, Alabama",77721,1498,17973,634,17468,843,505,519,44468,1520,38836,1947,5632,1700,15280,179,15280,179,0,216
"Tallapoosa County, Alabama",40300,549,8718,426,8285,642,433,515,22475,756,19428,1434,3047,1264,9107,368,9072,371,35,60
"Tuscaloosa County, Alabama",224217,2294,54027,2551,53140,2632,887,706,138626,3347,123879,3606,14747,3100,31564,676,31512,677,52,87
"Walker County, Alabama",63999,904,15717,683,15538,777,179,275,35554,1048,29892,1693,5662,1497,12728,376,12728,376,0,216
"Winston County, Alabama",23390,258,4874,772,4605,797,269,329,13557,939,10774,1067,2783,826,4959,856,4959,856,0,216
"Anchorage Municipality, Alaska",274696,1800,71800,922,66861,2043,4939,1753,166925,1820,147908,2985,19017,2637,35971,869,35021,1037,950,653
"Fairbanks North Star Borough, Alaska",85678,1718,23104,770,22383,989,721,564,50761,1961,42860,2358,7901,2032,11813,1016,11471,941,342,320
"Juneau City and Borough, Alaska",31709,273,7059,556,6294,631,765,594,20229,698,18448,993,1781,797,4421,390,4421,390,0,184
"Kenai Peninsula Borough, Alaska",58501,836,13563,256,12467,712,1096,635,33666,783,28243,1247,5423,1130,11272,213,11254,214,18,31
"Matanuska-Susitna Borough, Alaska",107222,874,29824,219,26596,1235,3228,1257,62871,933,51582,1873,11289,1706,14527,331,14457,334,70,84
"Apache County, Arizona",64936,665,18468,372,15607,1034,2861,947,35442,841,25491,1450,9951,1185,11026,521,10819,586,207,190
"Cochise County, Arizona",118706,2063,27871,664,26172,1077,1699,927,61229,2277,54557,2588,6672,1532,29606,542,29332,618,274,305
"Coconino County, Arizona",144555,741,33980,2090,31461,2494,2519,1061,90310,2331,77566,3257,12744,2282,20265,740,20236,742,29,39
"Gila County, Arizona",52690,942,10690,341,8609,1318,2081,1289,26180,1055,20669,1786,5511,1583,15820,543,15803,546,17,31
"Graham County, Arizona",36310,1224,10610,304,10008,592,602,508,20261,1314,17375,1504,2886,1162,5439,559,5439,559,0,224
"La Paz County, Arizona",19283,1490,4127,646,2799,768,1328,548,8369,846,6369,978,2000,692,6787,513,6739,524,48,83
"Maricopa County, Arizona",4458347,5220,1098940,3412,1013603,9865,85337,9128,2656249,6084,2273485,15602,382764,13275,703158,922,696356,2534,6802,2351
"Mohave County, Arizona",215783,1572,38154,1249,34533,1741,3621,1302,109905,1796,93771,3463,16134,2879,67724,502,67724,502,0,224
"Navajo County, Arizona",105930,990,29033,597,23542,1737,5491,1642,55213,938,43418,1922,11795,1952,21684,542,21478,561,206,147
"Pima County, Arizona",1031111,2841,230838,2035,213440,3372,17398,2896,585881,3269,513750,5984,72131,5639,214392,833,212924,1083,1468,664
"Pinal County, Arizona",433608,3559,105080,1008,95305,2313,9775,2144,234595,3370,199424,5061,35171,5433,93933,766,93178,888,755,419
"Santa Cruz County, Arizona",47826,129,13074,391,12243,826,831,735,25144,653,20163,1506,4981,1258,9608,513,9432,573,176,193
"Yavapai County, Arizona",241147,1170,39433,626,35671,1529,3762,1416,120178,1388,96901,3493,23277,3282,81536,837,81259,944,277,355
"Yuma County, Arizona",197437,1993,53982,730,45356,2619,8626,2557,103521,2069,79814,4008,23707,3712,39934,548,39758,593,176,179
"Baxter County, Arkansas",41843,260,7687,113,7574,163,113,137,21357,370,19424,793,1933,672,12799,266,12789,265,10,18
"Benton County, Arkansas",292160,980,79158,969,75006,1734,4152,1507,174289,1454,148589,3550,25700,3617,38713,450,38527,488,186,156
"Boone County, Arkansas",37406,370,9097,452,8667,426,430,397,20606,502,17809,1141,2797,1069,7703,315,7703,315,0,213
"Carroll County, Arkansas",28173,215,6504,423,6059,512,445,422,15300,467,12220,985,3080,937,6369,200,6322,228,47,82
"Clark County, Arkansas",21122,172,4671,1170,4219,1106,452,710,11954,1079,10740,1073,1214,469,4497,832,4497,832,0,213
"Cleburne County, Arkansas",24741,182,5280,372,4814,476,466,334,12836,378,11222,620,1614,506,6625,240,6625,240,0,213
"Columbia County, Arkansas",22380,218,5064,270,5019,236,45,80,12777,718,12034,924,743,505,4539,654,4522,657,17,30
"Conway County, Arkansas",22022,1450,4809,785,4572,819,237,207,12893,1092,10962,1218,1931,792,4320,554,4320,554,0,213
"Craighead County, Arkansas",111486,543,30759,1300,29805,1359,954,757,65482,1405,59549,2081,5933,1709,15245,627,15075,703,170,306
"Crawford County, Arkansas",59437,516,15073,765,13522,1893,1551,1698,34062,983,28899,1803,5163,1914,10302,615,10302,615,0,213
"Crittenden County, Arkansas",47186,269,13549,441,13314,454,235,194,26960,487,23330,947,3630,805,6677,120,6518,258,159,232
"Faulkner County, Arkansas",122935,1250,31373,880,29225,1650,2148,1134,75472,1589,67293,2108,8179,1715,16090,534,16016,575,74,125
"Garland County, Arkansas",99277,648,20793,785,19212,1034,1581,957,54834,926,45895,2752,8939,2704,23650,582,23500,621,150,216
"Greene County, Arkansas",45920,373,11636,558,11247,561,389,300,27093,638,23534,1262,3559,1217,7191,234,7191,234,0,213
"Hempstead County, Arkansas",19412,2334,4612,1358,3900,1448,712,786,12113,1581,10596,1697,1517,770,2687,612,2645,598,42,68
"Hot Spring County, Arkansas",30871,437,7401,392,6253,977,1148,860,16887,626,15037,936,1850,745,6583,233,6583,233,0,213
"Independence County, Arkansas",37275,278,9088,594,8544,741,544,447,21655,724,17624,1636,4031,1520,6532,428,6532,428,0,213
"Jefferson County, Arkansas",62097,908,15112,725,14317,834,795,676,35100,924,31371,1266,3729,1119,11885,220,11828,235,57,77
"Johnson County, Arkansas",25594,273,7051,908,6534,928,517,329,14185,870,12555,808,1630,803,4358,700,4358,700,0,213
"Logan County, Arkansas",21020,189,4951,336,4542,311,409,283,11969,324,10914,677,1055,560,4100,163,4100,163,0,213
"Lonoke County, Arkansas",72134,853,19257,374,18241,815,1016,675,42545,914,38589,1121,3956,941,10332,269,10332,269,0,213
"Miller County, Arkansas",41472,655,10458,635,9211,1337,1247,1066,24148,755,20463,1269,3685,1264,6866,314,6866,314,0,213
"Mississippi County, Arkansas",38858,510,10889,424,10529,558,360,381,21993,619,19070,1093,2923,1013,5976,164,5831,167,145,168
"Ouachita County, Arkansas",22016,168,5511,519,5473,523,38,74,11929,528,10669,798,1260,676,4576,160,4576,160,0,213
"Poinsett County, Arkansas",22446,182,5894,233,5327,468,567,409,12733,274,10039,686,2694,725,3819,182,3819,182,0,213
"Polk County, Arkansas",21011,1649,5916,896,5797,915,119,161,10811,1208,8874,1199,1937,788,4284,556,4284,556,0,213
"Pope County, Arkansas",63345,268,16057,746,14867,1004,1190,680,37392,838,31956,1784,5436,1623,9896,321,9879,320,17,29
"Pulaski County, Arkansas",389999,2140,95943,1004,89307,2404,6636,2354,230481,2148,200405,4098,30076,3905,63575,853,63542,857,33,54
"St. Francis County, Arkansas",20032,655,4847,113,4744,205,103,166,11426,786,10030,1047,1396,646,3759,459,3759,459,0,213
"Saline County, Arkansas",124347,625,30034,959,29680,969,354,316,71938,1217,65846,2095,6092,1717,22375,633,22375,633,0,213
"Sebastian County, Arkansas",126986,588,30770,702,28970,1036,1800,988,76498,1068,64407,2341,12091,2048,19718,646,19555,640,163,222
"Union County, Arkansas",37941,231,10275,419,10202,444,73,85,20413,595,18145,1135,2268,1052,7253,363,7253,363,0,213
"Washington County, Arkansas",248427,1126,64459,1066,59731,2013,4728,1771,153465,1937,131715,4441,21750,3970,30503,995,29653,876,850,849
"White County, Arkansas",76816,337,18763,675,17900,723,863,497,45749,667,39226,1629,6523,1672,12304,308,12304,308,0,213
"Yell County, Arkansas",19824,348,4453,931,4316,954,137,133,11980,867,10530,941,1450,588,3391,932,3391,932,0,213
"Alameda County, California",1640371,1691,351157,1999,342064,3081,9093,1921,1046755,2697,988849,5915,57906,5863,242459,644,240209,1079,2250,804
"Amador County, California",37816,428,6446,495,6420,494,26,54,20852,651,19946,803,906,551,10518,270,10488,275,30,52
"Butte County, California",205848,713,47954,907,46224,1294,1730,844,120605,1424,109427,2353,11178,1991,37289,900,37229,908,60,100
"Calaveras County, California",45739,406,8523,536,7763,1015,760,842,23629,672,21935,1178,1694,1012,13587,341,13587,341,0,218
"Colusa County, California",21744,250,6703,1051,5926,1092,777,699,12748,959,10296,1564,2452,1199,2293,852,2207,816,86,139
"Contra Costa County, California",1156218,846,271306,1644,263577,2600,7729,2113,692850,1843,653942,4683,38908,4477,192062,599,190772,837,1290,532
"Del Norte County, California",25696,345,6969,1179,6536,1232,433,382,14180,1059,12938,1163,1242,589,4547,1145,4342,1062,205,260
"El Dorado County, California",192335,499,39502,836,38486,1073,1016,750,109669,1189,104180,2151,5489,1614,43164,762,43164,762,0,218
"Fresno County, California",1001415,2785,300477,1709,294360,2542,6117,1841,575791,3215,525595,6787,50196,5923,125147,754,124024,1034,1123,666
"Glenn County, California",28601,211,8666,667,8527,720,139,207,15051,911,12805,1399,2246,963,4884,508,4865,512,19,43
"Humboldt County, California",135189,468,27724,973,26848,1121,876,454,81091,1158,73641,2201,7450,1967,26374,469,26332,481,42,63
"Imperial County, California",170254,983,54247,870,53967,938,280,315,91574,1259,85505,2197,6069,2019,24433,671,24304,716,129,194
"Kern County, California",889026,2794,276468,1801,264948,3370,11520,3261,509269,3128,452263,5391,57006,4607,103289,413,102275,738,1014,618
"Kings County, California",132592,2026,42831,576,41193,1318,1638,1260,73950,1905,68108,2492,5842,1576,15811,438,15688,456,123,135
"Lake County, California",68017,564,14225,486,14024,410,201,191,37367,1066,33844,1770,3523,1238,16425,817,16311,807,114,115
"Lassen County, California",23686,1800,5367,803,5126,856,241,391,13336,1213,11792,1308,1544,594,4983,188,4913,223,70,112
"Los Angeles County, California",9754769,3420,2186703,4735,2106949,8317,79754,6378,6157125,5614,5386556,16839,770569,16743,1410941,1775,1386740,3268,24201,2751
"Madera County, California",151932,1369,45903,1300,43503,1930,2400,1759,82697,1809,72511,3013,10186,2510,23332,1162,22731,905,601,815
"Marin County, California",256949,1150,53395,873,52205,1457,1190,1062,142763,1331,134330,2369,8433,2032,60791,770,60751,769,40,65
"Mariposa County, California",22429,2030,3489,1089,3489,1089,0,218,12831,2200,12390,2208,441,355,6109,1588,6109,1588,0,218
"Mendocino County, California",90458,708,19927,502,16970,1486,2957,1312,48999,994,43904,1811,5095,1465,21532,808,21525,806,7,14
"Merced County, California",283776,776,88437,1391,83499,1948,4938,1667,161943,1623,141667,3554,20276,3073,33396,588,32858,740,538,455
"Monterey County, California",421848,1967,119898,1245,116534,1673,3364,1301,239530,2325,200109,4106,39421,3623,62420,491,60899,944,1521,770
"Napa County, California",134893,461,28147,525,26307,1002,1840,831,79970,683,73405,1739,6565,1497,26776,402,26776,402,0,218
"Nevada County, California",102510,502,18137,550,16914,1076,1223,890,56040,771,50294,2083,5746,2082,28333,718,28312,721,21,37
"Orange County, California",3151798,2072,719119,2364,693023,4927,26096,4305,1939508,2609,1753848,9186,185660,9103,493171,1130,488219,1887,4952,1345
"Placer County, California",409508,952,96097,1130,94230,1643,1867,1001,231512,1418,222636,2768,8876,2458,81899,656,81604,703,295,320
"Riverside County, California",2435212,2242,638565,3013,613489,5753,25076,5116,1434553,3670,1264137,11510,170416,10532,362094,775,357681,1334,4413,1125
"Sacramento County, California",1570850,5238,388418,1764,379256,2298,9162,1938,951598,5309,885197,7437,66401,5214,230834,634,229494,825,1340,606
"San Benito County, California",66478,172,17695,316,17308,463,387,363,40055,395,36483,1092,3572,1030,8728,250,8728,250,0,218
"San Bernardino County, California",2154255,3361,598394,2365,570683,5301,27711,4980,1293941,3873,1133691,11169,160250,9933,261920,1011,258158,1358,3762,1060
"San Diego County, California",3170679,5907,736200,3165,709969,5521,26231,4268,1952692,6192,1773433,10451,179259,9601,481787,1376,475011,1820,6776,1454
"San Francisco County, California",811674,1054,121895,1220,119112,1871,2783,1387,548993,1364,527194,4018,21799,3801,140786,731,140171,932,615,573
"San Joaquin County, California",778891,2084,221508,1375,215803,2061,5705,1513,455822,2344,414187,4714,41635,4396,101561,738,100690,799,871,452
"San Luis Obispo County, California",277856,2417,55726,1673,53174,1835,2552,1589,162015,2766,149122,3573,12893,2476,60115,492,60022,502,93,113
"San Mateo County, California",734931,851,155003,992,150791,1782,4212,1424,452400,1174,429250,3964,23150,3690,127528,767,126257,937,1271,455
"Santa Barbara County, California",438044,1701,111656,1841,107623,2179,4033,1574,256568,2392,223204,4681,33364,3699,69820,870,68499,1330,1321,999
"Santa Clara County, California",1876273,1560,424029,2006,417751,2319,6278,1499,1182742,2456,1123707,5605,59035,5076,269502,841,265992,1482,3510,1309
"Santa Cruz County, California",266604,711,56402,1546,53852,2116,2550,1454,161527,1770,145402,3747,16125,3159,48675,510,47981,666,694,459
"Shasta County, California",180611,852,42025,633,39588,1150,2437,1033,101061,1047,91482,1928,9579,1792,37525,460,37375,528,150,241
"Siskiyou County, California",43846,223,9463,391,9139,476,324,264,22644,578,20918,757,1726,546,11739,471,11739,471,0,218
"Solano County, California",438545,1800,103090,991,99596,1949,3494,1595,261408,2099,244107,3336,17301,2690,74047,723,73506,774,541,383
"Sonoma County, California",482150,560,100963,1228,97423,1519,3540,1491,279546,1407,253685,3865,25861,3363,101641,855,101267,927,374,317
"Stanislaus County, California",550570,1135,157622,1184,152013,2195,5609,2041,319374,1674,284036,4831,35338,4703,73574,898,72903,1025,671,483
"Sutter County, California",97715,827,26068,809,25007,1065,1061,779,55940,1090,50577,1664,5363,1458,15707,287,15502,381,205,263
"Tehama County, California",64961,447,16952,642,15542,1143,1410,966,34311,932,31177,1780,3134,1228,13698,530,13420,516,278,394
"Tulare County, California",471685,2410,151372,1311,148305,1773,3067,1098,266172,2775,228014,4611,38158,4423,54141,565,53556,646,585,425
"Tuolumne County, California",52959,1239,10099,674,9798,765,301,372,27983,1235,25868,1363,2115,982,14877,432,14762,451,115,139
"Ventura County, California",832216,1717,195121,1558,185374,2835,9747,2447,498328,1886,434184,5794,64144,5269,138767,834,137998,965,769,403
"Yolo County, California",215973,691,50573,1270,47898,1877,2675,1381,137010,1427,128745,2572,8265,2139,28390,346,28390,346,0,218
"Yuba County, California",80932,818,24023,523,23350,730,673,612,45910,934,41782,1834,4128,1591,10999,545,10969,545,30,56
"Adams County, Colorado",519585,1740,139234,1185,131023,2910,8211,2985,323883,2045,267851,5379,56032,5269,56468,726,54897,1200,1571,1058
"Arapahoe County, Colorado",648188,1255,155765,1508,146269,2753,9496,2240,401806,1761,354609,4607,47197,4769,90617,418,89433,745,1184,597
"Boulder County, Colorado",327604,816,66959,1289,65312,1437,1647,1083,209049,1753,193656,2890,15393,2598,51596,733,51398,725,198,190
"Broomfield County, Colorado",74864,452,16656,414,16309,463,347,281,47114,563,44258,1212,2856,1100,11094,425,11034,432,60,101
"Chaffee County, Colorado",18929,930,2594,776,2594,776,0,211,11242,1066,10352,1110,890,583,5093,826,5093,826,0,211
"Delta County, Colorado",30581,474,6244,302,5990,440,254,364,15951,624,13676,1065,2275,879,8386,388,8315,401,71,116
"Denver County, Colorado",704748,1483,140183,1326,132824,2145,7359,2170,479992,1682,417261,5754,62731,5216,84573,551,83560,785,1013,546
"Douglas County, Colorado",367641,1261,94539,942,92427,1560,2112,1140,224774,1621,213746,2978,11028,2210,48328,515,48289,519,39,64
"Eagle County, Colorado",55671,111,13324,882,13009,891,315,354,33750,2216,27684,2741,6066,1948,8597,2053,8505,2090,92,191
"Elbert County, Colorado",27001,135,6516,553,6336,614,180,170,15515,537,14203,688,1312,417,4970,204,4970,204,0,211
"El Paso County, Colorado",699782,3825,181833,1400,174202,2937,7631,2421,420280,4318,382981,5983,37299,4553,97669,709,97096,815,573,388
"Fremont County, Colorado",39444,2722,8542,821,8235,712,307,319,20476,2319,18449,2110,2027,785,10426,498,10383,503,43,74
"Garfield County, Colorado",61644,362,16055,494,13591,1383,2464,1367,36686,857,28877,2056,7809,1875,8903,594,8870,600,33,55
"Jefferson County, Colorado",573891,1520,115247,778,112160,1275,3087,1068,359188,1729,332370,3579,26818,3155,99456,544,98792,734,664,453
"La Plata County, Colorado",55860,457,10696,467,9297,972,1399,839,33670,748,28639,1592,5031,1454,11494,401,11418,391,76,96
"Larimer County, Colorado",359113,1778,74049,1475,70176,2069,3873,1662,225135,2285,206629,3398,18506,2890,59929,506,59686,536,243,255
"Logan County, Colorado",21030,617,4832,1034,4809,1027,23,46,12136,1126,10997,1400,1139,672,4062,784,4062,784,0,211
"Mesa County, Colorado",155789,1193,34587,797,32662,1458,1925,1180,89199,1745,76216,3199,12983,2706,32003,869,31870,860,133,168
"Montezuma County, Colorado",26071,114,6195,525,5943,644,252,321,13436,691,12860,840,576,475,6440,645,6359,660,81,132
"Montrose County, Colorado",42796,456,9796,548,8558,1013,1238,875,22390,761,17526,1653,4864,1567,10610,456,10610,456,0,211
"Morgan County, Colorado",28680,338,7263,240,6345,821,918,804,16711,588,12363,1113,4348,1037,4706,610,4698,610,8,14
"Otero County, Colorado",20075,1757,5846,666,5784,664,62,120,10144,1589,9196,1519,948,585,4085,751,4085,751,0,211
"Pueblo County, Colorado",165578,1533,39127,705,37953,910,1174,701,94654,1918,86350,2359,8304,1590,31797,585,31741,587,56,89
"Routt County, Colorado",30183,1779,5836,648,5494,734,342,335,19303,1479,17587,1447,1716,714,5044,747,5009,742,35,64
"Summit County, Colorado",30906,70,5969,1761,5747,1754,222,386,19873,1736,18345,1568,1528,1105,5064,1147,5064,1147,0,211
"Teller County, Colorado",24790,174,4276,821,4276,821,0,211,15346,1186,12742,1431,2604,853,5168,1026,5168,1026,0,211
"Weld County, Colorado",337739,953,92981,876,90169,1468,2812,1278,202807,1168,179329,3252,23478,3006,41951,525,41784,574,167,223
"Fairfield County, Connecticut",952743,1476,223948,1703,218353,2127,5595,1712,573686,2167,515326,6831,58360,6433,155109,564,152749,1171,2360,984
"Hartford County, Connecticut",883382,1779,196862,1366,192658,2030,4204,1530,533026,2055,498845,4601,34181,3821,153494,984,152384,1099,1110,529
"Litchfield County, Connecticut",183144,576,35027,644,33578,985,1449,885,107096,1047,101020,2015,6076,1672,41021,677,40938,683,83,144
"Middlesex County, Connecticut",163099,586,29617,885,28904,1006,713,469,98819,1156,94254,2027,4565,1606,34663,727,34663,727,0,217
"New Haven County, Connecticut",854541,1231,181283,1433,177696,1985,3587,1310,521590,1883,484238,4659,37352,4412,151668,785,150633,1066,1035,686
"New London County, Connecticut",257626,1873,54794,966,53503,1217,1291,776,152976,2040,144512,2551,8464,1706,49856,929,49856,929,0,217
"Tolland County, Connecticut",148094,669,29874,1382,28370,1690,1504,1346,93197,1542,87567,2240,5630,2029,25023,531,24978,531,45,78
"Windham County, Connecticut",114897,902,23991,709,23712,777,279,309,71171,1323,65523,1888,5648,1514,19735,575,19735,575,0,217
"Kent County, Delaware",180572,1163,45743,1129,42807,2319,2936,1871,102741,1693,93914,2772,8827,2363,32088,565,31659,765,429,469
"New Castle County, Delaware",562859,893,130093,1345,126373,1852,3720,1417,339838,1552,315867,3529,23971,3394,92928,429,92397,674,531,538
"Sussex County, Delaware",244533,623,45974,465,44379,913,1595,775,125662,673,111095,1927,14567,1880,72897,385,72747,422,150,131
"District of Columbia, District of Columbia",659979,984,133787,1923,128871,2978,4916,2383,442448,2318,423637,3834,18811,3115,83744,847,83244,938,500,382
"Alachua County, Florida",276719,1543,59081,1430,57104,1715,1977,1015,176657,2212,156028,3789,20629,2780,40981,992,40052,996,929,571
"Baker County, Florida",24968,1642,6393,1324,5185,1308,1208,804,14644,1638,12615,2002,2029,877,3931,1195,3931,1195,0,242
"Bay County, Florida",175263,1096,37720,513,34383,1327,3337,1166,106002,1350,83409,2850,22593,3006,31541,844,31541,844,0,242
"Bradford County, Florida",23985,3085,5621,1276,4371,1117,1250,770,13573,2028,9593,1814,3980,1411,4791,653,4791,653,0,242
"Brevard County, Florida",611482,1137,118565,1085,109043,2963,9522,3039,345371,1582,289258,5476,56113,5444,147546,421,146947,587,599,375
"Broward County, Florida",1919674,2062,427209,2272,394554,4984,32655,4729,1157550,3135,957618,10319,199932,10086,334915,749,323438,2679,11477,2539
"Charlotte County, Florida",190368,2831,24904,860,22764,1114,2140,959,86970,2846,68606,3927,18364,3173,78494,936,77866,1073,628,473
"Citrus County, Florida",155759,1950,24415,972,22091,1809,2324,1584,74172,2351,56660,3630,17512,3659,57172,1019,57037,1022,135,166
"Clay County, Florida",219298,1279,54740,1216,53108,1530,1632,897,126882,1830,114975,3066,11907,2641,37676,969,37623,979,53,68
"Collier County, Florida",384298,943,66712,874,61039,2058,5673,2104,190626,1206,157238,3840,33388,3873,126960,542,126137,767,823,597
"Columbia County, Florida",64780,1745,15765,390,13996,747,1769,786,36467,1760,30140,1654,6327,1583,12548,590,12548,590,0,242
"DeSoto County, Florida",32797,610,7853,1787,7404,1714,449,504,17387,1905,12632,2216,4755,2144,7557,1572,7310,1718,247,567
"Duval County, Florida",975954,6530,235926,1446,216082,3221,19844,3517,593893,6815,496536,9600,97357,8062,146135,854,144841,1196,1294,931
"Escambia County, Florida",306215,2334,71239,1146,65832,2090,5407,1807,180035,2075,144694,3725,35341,3783,54941,1177,54448,1231,493,372
"Flagler County, Florida",120280,647,21255,771,18260,1866,2995,1736,61549,1608,51338,2528,10211,2043,37476,1140,37439,1137,37,67
"Gadsden County, Florida",40834,940,9657,264,8419,1253,1238,1227,23070,934,18437,1582,4633,1241,8107,231,8107,231,0,242
"Gilchrist County, Florida",20301,2891,4824,1405,4571,1418,253,253,11849,2016,9299,1935,2550,1123,3628,907,3628,907,0,242
"Hardee County, Florida",23614,535,5901,1190,5617,1218,284,258,13925,1421,8132,1436,5793,1609,3788,1361,3702,1350,86,94
"Hendry County, Florida",39826,542,11113,1954,9520,2037,1593,1451,23130,1803,16474,2424,6656,1856,5583,1353,5464,1364,119,169
"Hernando County, Florida",198843,879,39402,929,36863,1502,2539,1231,106174,1186,84963,3232,21211,3190,53267,713,52753,771,514,453
"Highlands County, Florida",102146,827,17864,481,15935,1359,1929,1258,47562,1317,35295,2226,12267,2169,36720,932,36631,928,89,149
"Hillsborough County, Florida",1463199,2776,344618,2107,330053,3415,14565,2929,902367,3217,754143,9060,148224,8864,216214,771,213744,1406,2470,1078
"Indian River County, Florida",162524,552,27048,1440,25474,1659,1574,924,79327,1630,62827,3179,16500,2876,56149,1091,55777,1160,372,504
"Jackson County, Florida",39720,2117,9604,760,9051,716,553,343,21168,1932,17713,2103,3455,1406,8948,302,8926,303,22,46
"Lake County, Florida",391718,1225,80167,1088,75522,2254,4645,2108,207317,1850,174648,4726,32669,4579,104234,708,103742,800,492,400
"Lee County, Florida",783164,3077,144521,1291,133710,2751,10811,2630,411457,3272,335387,7220,76070,6365,227186,384,226220,668,966,505
"Leon County, Florida",289536,2290,64391,1248,60989,1918,3402,1390,182983,2379,162645,3825,20338,3454,42162,639,42075,626,87,129
"Levy County, Florida",43871,442,9503,390,9095,683,408,533,23520,903,18242,1554,5278,1361,10848,762,10848,762,0,242
"Manatee County, Florida",409420,1136,75748,938,69566,2303,6182,2141,218749,1464,177032,5301,41717,5307,114923,713,114687,698,236,262
"Marion County, Florida",379200,1589,75335,1396,70108,2306,5227,2050,194287,2256,153188,5283,41099,5089,109578,691,109449,716,129,190
"Martin County, Florida",156879,1077,28226,782,24468,1785,3758,1522,78493,1691,63065,2754,15428,2508,50160,1100,49663,1121,497,445
"Miami-Dade County, Florida",2640092,2951,565886,2514,528880,5155,37006,4727,1630067,4062,1308230,14688,321837,13906,444139,900,434912,1986,9227,1651
"Monroe County, Florida",80081,1072,13432,992,11781,1150,1651,895,47645,1261,34585,1960,13060,1989,19004,242,18836,302,168,196
"Nassau County, Florida",93399,801,19039,880,18253,1030,786,599,51431,1682,44546,2590,6885,2861,22929,1432,22929,1432,0,242
"Okaloosa County, Florida",198282,2075,49537,560,45983,1449,3554,1442,114645,2089,94770,4042,19875,3432,34100,619,33560,691,540,527
"Okeechobee County, Florida",38175,2771,8950,951,7708,1024,1242,1144,20654,2223,15289,2223,5365,1589,8571,962,8571,962,0,242
"Orange County, Florida",1413231,1664,329499,2705,310248,4674,19251,3905,904220,3084,745405,10883,158815,10742,179512,731,175311,2083,4201,1969
"Osceola County, Florida",401495,1154,101569,1345,95825,2387,5744,1994,246386,1703,205335,5679,41051,5173,53540,828,53176,775,364,335
"Palm Beach County, Florida",1487107,2393,300388,1534,269185,5287,31203,4907,824355,2808,668257,8872,156098,8946,362364,564,357400,1119,4964,1038
"Pasco County, Florida",579042,3390,125805,1073,118904,2538,6901,2401,326304,3331,267989,6049,58315,5037,126933,552,126203,663,730,461
"Pinellas County, Florida",944794,2579,158306,1128,145244,3046,13062,2909,544439,2905,452499,6649,91940,5954,242049,808,240976,1045,1073,543
"Polk County, Florida",745267,1510,176475,1441,165263,2751,11212,2484,420808,1842,332177,7435,88631,7397,147984,416,146719,936,1265,810
"Putnam County, Florida",73357,484,16443,362,15892,486,551,396,39568,607,27638,2187,11930,2217,17346,492,17346,492,0,242
"St. Johns County, Florida",290175,1371,68039,1468,64759,1930,3280,1425,162822,2374,146959,3977,15863,3372,59314,1544,58789,1680,525,470
"St. Lucie County, Florida",340772,3275,71555,1431,65133,2873,6422,2793,185751,3575,151439,6231,34312,5626,83466,525,83406,533,60,91
"Santa Rosa County, Florida",182503,2330,44576,729,41458,1443,3118,1580,106468,2633,89923,3289,16545,2848,31459,826,31459,826,0,242
"Sarasota County, Florida",442850,1104,65280,825,55206,3002,10074,2966,213818,1147,178623,5330,35195,5225,163752,733,163326,789,426,333
"Seminole County, Florida",467310,1753,101927,812,94226,2499,7701,2330,289698,1864,247341,4643,42357,4312,75685,444,74291,994,1394,853
"Sumter County, Florida",127373,1207,9785,365,9004,738,781,754,39050,1305,31920,2034,7130,1588,78538,807,77769,824,769,632
"Suwannee County, Florida",43640,405,9610,1821,8586,1847,1024,954,24579,1270,18910,1809,5669,1537,9451,1468,9451,1468,0,242
"Taylor County, Florida",20314,1985,6400,1639,6400,1639,0,242,10605,1732,8345,1775,2260,1391,3309,1026,3309,1026,0,242
"Volusia County, Florida",558176,1814,106179,1647,98109,2449,8070,2416,312454,2036,248595,6000,63859,6060,139543,683,139128,746,415,339
"Wakulla County, Florida",31374,945,6130,1209,6037,1227,93,159,18763,1640,17917,1818,846,531,6481,1203,6481,1203,0,242
"Walton County, Florida",78758,1065,16459,257,12681,2818,3778,2712,46552,1084,39630,2902,6922,2956,15747,658,15747,658,0,242
"Washington County, Florida",22774,477,5690,1262,4903,1389,787,797,12655,1428,10781,1316,1874,782,4429,747,4350,759,79,132
"Baldwin County, Georgia",40462,1139,9385,1156,8545,1120,840,791,23890,1000,17872,1927,6018,1580,7187,379,7187,379,0,247
"Barrow County, Georgia",86532,246,23058,462,21443,931,1615,823,52325,1058,40483,2297,11842,2169,11149,953,10996,947,153,207
"Bartow County, Georgia",109521,771,27998,1046,26907,1253,1091,771,65807,1347,51778,2987,14029,2570,15716,739,15661,732,55,94
"Bibb County, Georgia",153355,1796,40561,1044,37695,1554,2866,1177,88393,1931,67590,2801,20803,2360,24401,445,24356,448,45,72
"Bryan County, Georgia",45428,730,14063,1252,13417,1481,646,606,25271,1428,21847,1776,3424,1510,6094,1254,6094,1254,0,247
"Bulloch County, Georgia",79053,2849,18257,1539,17136,1737,1121,900,51695,2883,40762,2944,10933,2293,9101,498,9101,498,0,247
"Burke County, Georgia",24151,239,6522,1185,6522,1185,0,247,14922,1265,11496,1333,3426,1404,2707,702,2707,702,0,247
"Butts County, Georgia",23856,710,6127,721,5733,821,394,535,13182,997,10933,1286,2249,929,4547,764,4547,764,0,247
"Camden County, Georgia",51426,1312,13932,649,12578,1187,1354,883,29421,1585,25222,1660,4199,1428,8073,719,8073,719,0,247
"Carroll County, Georgia",120974,1065,30945,1074,29522,1219,1423,1090,73283,1520,58061,2991,15222,2716,16746,463,16660,479,86,137
"Catoosa County, Georgia",68010,369,16433,697,14852,615,1581,904,39090,799,32066,1708,7024,1701,12487,420,12433,427,54,95
"Chatham County, Georgia",289281,1265,65465,1016,63081,1469,2384,1105,174737,1740,145604,4116,29133,3832,49079,816,48801,840,278,300
"Chattooga County, Georgia",24106,2593,5608,1342,5490,1339,118,122,13181,1648,9750,1423,3431,1152,5317,725,5317,725,0,247
"Cherokee County, Georgia",272767,1618,66680,1043,62591,1739,4089,1550,163959,2324,142157,4348,21802,3935,42128,1419,42005,1356,123,188
"Clarke County, Georgia",127249,1153,28150,2222,26343,2431,1807,1024,84093,2332,72494,3853,11599,2967,15006,504,14675,457,331,366
"Clayton County, Georgia",294419,1627,84889,1329,78689,2828,6200,2553,179530,2212,137520,4551,42010,4221,30000,927,29917,932,83,97
"Cobb County, Georgia",760778,1620,182112,1395,169825,3115,12287,2817,477682,1841,396542,6749,81140,6820,100984,251,100057,491,927,455
"Coffee County, Georgia",40667,1102,11054,724,10005,975,1049,564,24179,1339,16151,1642,8028,1724,5434,683,5434,683,0,247
"Colquitt County, Georgia",45487,173,12140,407,10471,1064,1669,958,26012,1007,17789,2053,8223,2223,7335,960,7335,960,0,247
"Columbia County, Georgia",155853,1499,43636,1600,41036,2654,2600,1997,89061,2359,80096,3719,8965,2931,23156,776,23156,776,0,247
"Coweta County, Georgia",149355,584,36238,494,35233,861,1005,764,91499,954,81060,2662,10439,2519,21618,562,21562,514,56,128
"Dawson County, Georgia",27764,909,5981,1601,5781,1633,200,332,16812,1560,13872,1738,2940,1253,4971,1559,4897,1542,74,121
"Decatur County, Georgia",26636,2719,6922,1370,6538,1391,384,395,14828,1669,11383,1590,3445,1280,4886,738,4886,738,0,247
"DeKalb County, Georgia",752976,1117,178653,1630,170264,3465,8389,3190,472837,1853,391832,6880,81005,6921,101486,337,100512,553,974,571
"Dodge County, Georgia",18219,713,3953,949,3871,962,82,139,11320,1111,8154,1333,3166,1430,2946,717,2946,717,0,247
"Dougherty County, Georgia",83164,1122,20998,735,19224,1794,1774,1544,48072,1390,36626,2227,11446,2200,14094,397,14064,391,30,64
"Douglas County, Georgia",143731,1466,37926,1064,36593,1602,1333,1203,88075,1912,74905,3787,13170,3167,17730,1250,17730,1250,0,247
"Effingham County, Georgia",65489,799,18215,818,17127,1079,1088,820,39700,1158,34182,1839,5518,1434,7574,503,7522,517,52,92
"Emanuel County, Georgia",22227,2591,5930,1111,5915,1116,15,31,12454,1716,8753,1474,3701,1103,3843,793,3722,776,121,212
"Fannin County, Georgia",25709,165,3548,1300,2794,1306,754,489,13783,1669,11211,1787,2572,1020,8378,1557,8378,1557,0,247
"Fayette County, Georgia",119745,676,28770,669,27624,1017,1146,720,68475,786,63145,1627,5330,1453,22500,430,22490,430,10,22
"Floyd County, Georgia",96431,1242,24249,768,22677,1435,1572,1218,56183,1548,43323,2819,12860,2288,15999,494,15900,527,99,119
"Forsyth County, Georgia",259450,781,71167,887,66379,1785,4788,1645,156447,1198,139507,3101,16940,3022,31836,770,31348,1021,488,562
"Franklin County, Georgia",23605,246,5559,983,5264,1065,295,347,13388,1275,8682,1150,4706,1295,4658,1033,4658,1033,0,247
"Fulton County, Georgia",1052507,5476,243326,2319,227330,5553,15996,5336,680523,5797,599469,9216,81054,8594,128658,826,127170,1108,1488,764
"Gilmer County, Georgia",31871,225,5973,1401,4948,1519,1025,696,18400,1515,13384,2061,5016,1695,7498,1620,7418,1622,80,137
"Glynn County, Georgia",83578,896,19636,1378,17917,1745,1719,1120,45446,1808,34663,2975,10783,2772,18496,1084,18496,1084,0,247
"Gordon County, Georgia",57843,502,16437,1255,14840,1329,1597,1239,32459,1400,23982,2594,8477,2649,8947,654,8947,654,0,247
"Grady County, Georgia",25782,199,5835,1073,4905,1158,930,1109,14275,940,10371,1599,3904,1407,5672,866,5672,866,0,247
"Gwinnett County, Georgia",959683,1771,265175,2112,240619,4292,24556,4376,589167,3086,463987,8761,125180,8787,105341,390,103177,971,2164,891
"Habersham County, Georgia",44490,1315,11660,618,10476,1212,1184,942,23852,1281,18302,1852,5550,1464,8978,814,8861,825,117,198
"Hall County, Georgia",206044,807,52845,525,46569,2064,6276,1991,121553,1177,90048,4432,31505,4249,31646,1057,31367,1133,279,275
"Haralson County, Georgia",30381,2662,7355,1289,7305,1261,50,91,18290,1634,14493,1879,3797,1349,4736,652,4582,671,154,233
"Harris County, Georgia",34744,681,7885,324,7664,354,221,229,20172,664,18077,1183,2095,1040,6687,341,6687,341,0,247
"Hart County, Georgia",26295,2405,5665,1378,5567,1398,98,176,15167,1547,12336,1810,2831,1041,5463,948,5463,948,0,247
"Henry County, Georgia",243311,1375,64438,1233,59350,2628,5088,2422,148501,2131,130024,3769,18477,3546,30372,901,30250,926,122,195
"Houston County, Georgia",161330,1755,44413,1434,40609,2613,3804,1960,95516,2401,78041,3954,17475,3311,21401,482,21401,482,0,247
"Jackson County, Georgia",79723,481,21766,818,20407,1113,1359,870,46632,1178,37357,2378,9275,2332,11325,753,11325,753,0,247
"Jones County, Georgia",28137,340,7371,1445,7226,1439,145,174,15909,1289,12896,1252,3013,1089,4857,1144,4857,1144,0,247
"Laurens County, Georgia",48863,526,12530,353,11647,643,883,477,27726,502,22459,1693,5267,1655,8607,311,8607,311,0,247
"Lee County, Georgia",31941,580,8821,1140,8485,1125,336,397,18431,1269,16878,1356,1553,766,4689,887,4689,887,0,247
"Liberty County, Georgia",56565,1622,19494,702,17535,1584,1959,1463,30207,1508,24570,1648,5637,1395,6864,295,6822,291,42,74
"Lowndes County, Georgia",112426,1654,31661,1246,29637,1617,2024,1215,65626,1914,49805,3167,15821,2664,15139,411,15133,411,6,14
"Lumpkin County, Georgia",33978,280,6668,1193,6614,1197,54,56,21693,1106,18831,1425,2862,1109,5617,1400,5604,1401,13,22
"McDuffie County, Georgia",21440,283,5205,1047,5205,1047,0,247,12222,872,11238,1287,984,961,4013,947,4013,947,0,247
"Madison County, Georgia",30610,331,8365,1055,8274,1045,91,157,16494,1152,12037,1826,4457,1271,5751,940,5751,940,0,247
"Meriwether County, Georgia",20520,1558,4704,687,4280,713,424,429,11427,1184,9427,1450,2000,845,4389,651,4350,655,39,70
"Mitchell County, Georgia",19057,1253,5532,1021,5137,1028,395,399,10804,1186,7057,1305,3747,1339,2721,855,2721,855,0,247
"Monroe County, Georgia",27537,528,5631,1207,5310,1219,321,396,16092,1382,13861,1854,2231,1160,5814,1348,5814,1348,0,247
"Morgan County, Georgia",20451,267,5045,1214,4531,1388,514,711,11502,905,9867,1315,1635,1215,3904,1193,3904,1193,0,247
"Murray County, Georgia",39558,421,10759,984,10042,1087,717,642,22575,1050,17729,1526,4846,1686,6224,367,6110,354,114,173
"Muscogee County, Georgia",197054,1650,52896,738,50779,1257,2117,1066,115879,1797,94777,3004,21102,3180,28279,838,28279,838,0,247
"Newton County, Georgia",114677,549,32044,1413,30328,1610,1716,1102,67591,1486,61339,2062,6252,1844,15042,291,15042,291,0,247
"Oconee County, Georgia",42935,154,12191,963,11862,965,329,319,23202,1171,21529,1365,1673,770,7542,558,7542,558,0,247
"Paulding County, Georgia",171517,1487,49071,1615,46766,1843,2305,1521,101431,2613,90548,3885,10883,2834,21015,1010,20303,1161,712,596
"Peach County, Georgia",28409,18,5764,1357,5764,1357,0,247,16452,1439,13169,1924,3283,1653,6193,1253,6193,1253,0,247
"Pickens County, Georgia",33888,154,6681,649,6664,647,17,32,19309,726,15939,1503,3370,1384,7898,276,7898,276,0,247
"Polk County, Georgia",43293,196,12392,718,11976,764,416,357,24458,825,19290,1711,5168,1591,6443,435,6443,435,0,247
"Putnam County, Georgia",22500,146,3606,879,3606,879,0,247,12907,943,10424,1731,2483,1572,5987,1403,5584,1300,403,426
"Richmond County, Georgia",191607,1968,49472,1066,47984,1254,1488,766,111854,2028,87577,4211,24277,4103,30281,505,30201,512,80,137
"Rockdale County, Georgia",93265,705,23631,678,20884,1330,2747,1289,55343,1029,44514,2203,10829,2052,14291,854,14291,854,0,247
"Spalding County, Georgia",67190,848,16036,339,14531,1340,1505,1260,38460,949,30166,2510,8294,2451,12694,416,12666,420,28,51
"Stephens County, Georgia",26865,1,6613,1034,6182,1165,431,471,15193,1234,11182,1280,4011,1458,5059,1034,5059,1034,0,247
"Sumter County, Georgia",28550,827,7513,625,7468,648,45,98,16345,1051,13393,1215,2952,987,4692,489,4692,489,0,247
"Tattnall County, Georgia",23410,2652,8765,1278,8697,1269,68,123,11880,2088,8615,1489,3265,1444,2765,721,2765,721,0,247
"Thomas County, Georgia",45597,140,11694,640,10029,1441,1665,1278,25566,630,20745,1272,4821,1345,8337,152,8297,161,40,69
"Tift County, Georgia",40664,494,11395,1038,10981,1061,414,471,23358,1248,18013,1993,5345,1636,5911,541,5911,541,0,247
"Toombs County, Georgia",26707,219,8068,1427,6738,960,1330,1040,14359,1483,11523,1787,2836,1217,4280,979,4180,962,100,180
"Troup County, Georgia",68366,1129,16987,948,16101,1128,886,713,40270,1412,33839,2011,6431,1783,11109,675,11109,675,0,247
"Union County, Georgia",24713,2875,4391,1947,4137,1869,254,304,11143,1745,8508,1695,2635,720,9179,1687,9157,1684,22,39
"Upson County, Georgia",27333,260,6129,1115,5700,1190,429,581,15486,1169,12158,1362,3328,1395,5718,889,5510,890,208,310
"Walker County, Georgia",67375,998,15713,985,14943,1223,770,654,38315,1473,31683,1532,6632,1785,13347,850,13312,854,35,65
"Walton County, Georgia",98591,989,25118,712,23595,1200,1523,1022,56634,1092,46199,2233,10435,1866,16839,560,16761,563,78,127
"Ware County, Georgia",33979,674,9551,682,8834,783,717,669,18472,977,13572,1454,4900,1080,5956,479,5956,479,0,247
"Washington County, Georgia",17821,942,5503,881,5421,886,82,92,9069,1080,6922,976,2147,836,3249,752,3185,733,64,117
"Wayne County, Georgia",28418,821,8044,591,7105,362,939,589,15483,932,10898,1636,4585,1520,4891,433,4891,433,0,247
"White County, Georgia",31809,2566,7670,1367,7334,1416,336,346,17019,1837,14155,2152,2864,1454,7120,1328,7120,1328,0,247
"Whitfield County, Georgia",102066,817,27342,845,25541,1253,1801,964,59832,1502,43853,2655,15979,2392,14892,908,14759,924,133,189
"Worth County, Georgia",20405,141,5135,1032,5135,1032,0,247,11331,977,8044,1108,3287,1134,3939,891,3939,891,0,247
"Hawaii County, Hawaii",201263,807,43973,570,42445,1103,1528,968,111247,1187,104431,2445,6816,2199,46043,828,45705,875,338,301
"Honolulu County, Hawaii",944988,3291,219989,1232,214408,2194,5581,1785,539951,3492,511448,4102,28503,3067,185048,743,183422,1291,1626,1021
"Kauai County, Hawaii",72638,621,17302,749,16545,988,757,641,39923,947,37456,1193,2467,950,15413,429,15320,422,93,155
"Maui County, Hawaii",162789,495,36870,654,35781,765,1089,514,93716,761,88052,1762,5664,1822,32203,483,32203,483,0,200
"Ada County, Idaho",503358,2709,122303,1205,116595,2557,5708,2239,302796,2654,273452,5933,29344,5360,78259,758,77527,955,732,615
"Bannock County, Idaho",87368,906,23566,536,23222,535,344,216,50830,1009,45912,1580,4918,1328,12972,468,12972,468,0,214
"Bingham County, Idaho",48622,291,15849,850,14163,780,1686,1126,25522,938,22590,1206,2932,806,7251,433,7197,441,54,83
"Blaine County, Idaho",24847,1957,6259,755,5500,896,759,575,14113,1225,12418,1410,1695,694,4475,777,4475,777,0,214
"Bonner County, Idaho",49314,181,10260,437,9675,565,585,436,26421,471,22131,1296,4290,1217,12633,206,12633,206,0,214
"Bonneville County, Idaho",127089,771,40013,520,38426,1031,1587,908,70161,992,61263,2249,8898,2021,16915,526,16867,539,48,84
"Canyon County, Idaho",241827,642,69033,767,62463,1912,6570,1742,137881,931,120599,2897,17282,2966,34913,586,34842,569,71,129
"Cassia County, Idaho",27701,1893,10006,938,8851,1180,1155,697,14518,1270,11791,1353,2727,1002,3177,577,3146,589,31,57
"Elmore County, Idaho",23801,1848,7742,1094,7245,1168,497,418,12238,1306,10112,1328,2126,866,3821,758,3732,767,89,141
"Jefferson County, Idaho",32088,259,11256,474,9310,1324,1946,1194,17084,551,14499,1219,2585,1240,3748,123,3748,123,0,214
"Jerome County, Idaho",25932,2416,7589,1382,6831,1455,758,493,14300,1362,11928,1393,2372,808,4043,826,4043,826,0,214
"Kootenai County, Idaho",178732,515,42070,729,39695,1223,2375,1067,102142,953,90863,2607,11279,2535,34520,549,34417,570,103,170
"Latah County, Idaho",40176,138,8918,722,7342,1502,1576,1217,25607,719,23035,1325,2572,1100,5651,153,5627,143,24,50
"Madison County, Idaho",53779,124,16822,1798,16431,1888,391,374,33063,1809,31150,2254,1913,1769,3894,94,3894,94,0,214
"Minidoka County, Idaho",20483,2209,5370,1458,4769,1362,601,497,11569,1105,8714,1389,2855,1201,3544,564,3544,564,0,214
"Nez Perce County, Idaho",41772,433,9849,721,9336,780,513,260,23349,740,20561,1163,2788,920,8574,243,8553,230,21,48
"Payette County, Idaho",26176,160,8454,886,8231,841,223,261,13892,1047,12960,1112,932,521,3830,1071,3830,1071,0,214
"Twin Falls County, Idaho",91111,1132,26433,638,25248,830,1185,737,49670,1255,40236,2033,9434,1818,15008,636,15008,636,0,214
"Adams County, Illinois",64054,350,15941,605,15632,759,309,343,35436,660,33641,1011,1795,787,12677,542,12666,546,11,18
"Boone County, Illinois",52893,207,13470,580,13118,593,352,451,30749,758,27029,1577,3720,1370,8674,486,8674,486,0,201
"Bureau County, Illinois",32534,195,7297,219,6632,820,665,799,18280,234,16477,653,1803,596,6957,177,6957,177,0,201
"Champaign County, Illinois",204475,668,47110,1623,45277,2124,1833,1137,130658,1719,122424,2997,8234,2423,26707,645,26314,586,393,452
"Christian County, Illinois",31381,575,7439,582,7373,587,66,116,17352,751,16236,811,1116,453,6590,219,6577,220,13,25
"Clinton County, Illinois",34586,856,7867,277,7451,430,416,403,20440,819,18566,842,1874,705,6279,201,6262,196,17,30
"Coles County, Illinois",45979,366,9090,472,8631,656,459,423,28934,583,25816,1437,3118,1272,7955,336,7955,336,0,201
"Cook County, Illinois",5127986,2862,1173816,3270,1132800,5339,41016,5135,3167540,4001,2760406,15180,407134,14485,786630,1769,776592,2508,10038,1851
"DeKalb County, Illinois",99875,316,23992,1145,23617,1153,375,332,62871,1414,57756,1576,5115,1514,13012,708,12977,710,35,60
"DuPage County, Illinois",917694,2168,218634,1428,213465,2266,5169,1675,548408,1651,510386,3827,38022,3778,150652,1609,150023,1612,629,295
"Effingham County, Illinois",34132,183,9036,329,8948,347,88,103,19027,336,17667,596,1360,474,6069,184,6059,183,10,17
"Fayette County, Illinois",20661,356,5317,398,4963,546,354,375,11071,441,9527,750,1544,641,4273,217,4273,217,0,201
"Franklin County, Illinois",37061,143,8754,339,7955,511,799,508,20756,376,18480,799,2276,685,7551,190,7505,194,46,58
"Fulton County, Illinois",30807,1590,6931,356,6719,373,212,195,17061,1435,16425,1534,636,291,6815,167,6789,176,26,47
"Grundy County, Illinois",52557,288,13720,557,13646,552,74,94,31251,700,30204,850,1047,635,7586,333,7384,462,202,299
"Henry County, Illinois",48273,389,11195,326,11013,477,182,224,27095,476,25321,740,1774,788,9983,209,9983,209,0,201
"Iroquois County, Illinois",26456,170,5941,190,5794,208,147,128,14983,170,13901,564,1082,501,5532,175,5532,175,0,201
"Jackson County, Illinois",52126,231,11037,562,10213,920,824,818,32258,771,30095,1098,2163,782,8831,511,8725,485,106,153
"Jefferson County, Illinois",35048,901,8552,385,7340,670,1212,527,19414,757,16947,888,2467,698,7082,394,7071,392,11,18
"Jersey County, Illinois",21054,225,4528,768,4528,768,0,201,12946,918,11723,953,1223,605,3580,882,3580,882,0,201
"Jo Daviess County, Illinois",21841,93,4021,314,4015,310,6,16,11605,295,11010,457,595,313,6215,136,6215,136,0,201
"Kane County, Illinois",510927,1824,132077,1122,129145,1994,2932,1457,303912,2065,273319,4262,30593,3715,74938,955,74085,1192,853,662
"Kankakee County, Illinois",105367,508,25737,704,25107,850,630,376,60889,915,55627,1637,5262,1376,18741,678,18616,723,125,197
"Kendall County, Illinois",133727,1215,39750,1160,39582,1225,168,229,79629,2005,75051,3100,4578,1889,14348,1091,14290,1097,58,97
"Knox County, Illinois",46315,1111,10336,313,10040,366,296,271,25398,1091,22639,1279,2759,843,10581,379,10540,403,41,71
"Lake County, Illinois",693821,2010,177956,1449,172648,2142,5308,1597,409433,2041,366518,4132,42915,3823,106432,634,105032,841,1400,528
"LaSalle County, Illinois",106061,887,23749,476,22996,760,753,560,61601,984,57330,1708,4271,1296,20711,439,20711,439,0,201
"Lee County, Illinois",31242,642,6958,136,6882,192,76,127,17830,604,16744,743,1086,395,6454,444,6397,437,57,90
"Livingston County, Illinois",33474,740,7714,362,7336,446,378,318,19496,718,17320,895,2176,873,6264,188,6264,188,0,201
"Logan County, Illinois",25431,508,5575,230,5496,250,79,100,14925,470,14473,516,452,317,4931,219,4924,217,7,16
"McDonough County, Illinois",26470,171,5544,531,4973,737,571,490,16362,507,14607,802,1755,675,4564,165,4564,165,0,201
"McHenry County, Illinois",309809,716,74931,1159,73253,1401,1678,1144,187038,1644,175213,2955,11825,2475,47840,817,47727,837,113,142
"McLean County, Illinois",170056,417,40285,857,39310,1004,975,464,105467,1067,97578,1879,7889,1671,24304,585,24253,591,51,84
"Macon County, Illinois",100449,942,24565,484,23070,1204,1495,1111,54769,1114,50748,1780,4021,1436,21115,190,21029,207,86,86
"Macoupin County, Illinois",43946,240,9808,487,9773,498,35,43,25088,363,23300,755,1788,724,9050,275,9050,275,0,201
"Madison County, Illinois",262106,1013,61009,1089,60207,1198,802,550,154260,1390,143080,2686,11180,2496,46837,605,46718,629,119,144
"Marion County, Illinois",36808,242,9322,325,9116,337,206,213,20663,355,18737,630,1926,538,6823,248,6823,248,0,201
"Monroe County, Illinois",34658,270,8453,657,8343,762,110,189,19660,688,18987,844,673,400,6545,182,6545,182,0,201
"Montgomery County, Illinois",25896,409,5833,328,5625,487,208,318,14344,351,13516,466,828,385,5719,238,5688,242,31,52
"Morgan County, Illinois",31109,691,6492,362,6424,357,68,95,18170,728,17072,911,1098,523,6447,271,6447,271,0,201
"Ogle County, Illinois",51032,305,12235,423,11963,502,272,271,28827,452,26328,1235,2499,1098,9970,276,9970,276,0,201
"Peoria County, Illinois",176805,949,45379,741,44939,855,440,337,100673,1054,90022,3030,10651,2843,30753,663,30590,716,163,227
"Perry County, Illinois",18643,777,4315,521,4315,521,0,201,10605,693,9991,709,614,421,3723,213,3723,213,0,201
"Randolph County, Illinois",26373,1429,6241,429,5856,374,385,330,14679,1074,13262,1238,1417,652,5453,437,5427,441,26,44
"Rock Island County, Illinois",140552,1134,34076,722,32925,979,1151,582,77774,1196,68824,1786,8950,1584,28702,667,28647,675,55,107
"St. Clair County, Illinois",247756,1773,62954,749,61341,1205,1613,827,142476,2035,130613,3325,11863,2357,42326,529,42326,529,0,201
"Saline County, Illinois",22903,331,4947,207,4747,219,200,197,13296,232,12165,580,1131,470,4660,299,4660,299,0,201
"Sangamon County, Illinois",192285,1086,44027,598,43073,916,954,757,112467,1164,105325,2041,7142,1616,35791,461,35731,444,60,96
"Shelby County, Illinois",20620,111,4771,198,4606,245,165,186,11119,206,10600,407,519,329,4730,103,4730,103,0,201
"Stephenson County, Illinois",43446,289,9180,594,8800,604,380,350,24209,785,20778,1099,3431,1159,10057,554,10057,554,0,201
"Tazewell County, Illinois",127762,802,30656,455,29528,902,1128,715,72570,860,67751,1456,4819,1137,24536,388,24301,537,235,377
"Vermilion County, Illinois",70394,1023,17818,327,17463,400,355,243,38361,1271,34661,1695,3700,1142,14215,568,14215,568,0,201
"Whiteside County, Illinois",54594,261,13063,601,12582,748,481,408,30108,684,27850,1067,2258,754,11423,324,11394,329,29,47
"Will County, Illinois",690861,1527,176309,1344,170912,2066,5397,1644,418700,1523,382775,4661,35925,4651,95852,808,95652,803,200,220
"Williamson County, Illinois",64570,1409,14530,509,14267,615,263,271,37285,1372,34312,1464,2973,1048,12755,309,12564,316,191,175
"Winnebago County, Illinois",279675,1104,69623,791,66487,1519,3136,1373,159049,1302,142708,2882,16341,2754,51003,582,50868,602,135,166
"Woodford County, Illinois",37683,303,9734,322,9359,441,375,346,21084,436,20186,512,898,365,6865,361,6865,361,0,201
"Adams County, Indiana",35345,424,11413,501,7429,2002,3984,2156,18733,577,14922,1176,3811,1037,5199,291,4926,395,273,268
"Allen County, Indiana",385201,1267,103125,917,96686,2045,6439,1936,225458,1446,199305,3382,26153,3120,56618,930,56198,878,420,338
"Bartholomew County, Indiana",81650,468,20361,306,20345,310,16,20,48224,642,44646,1355,3578,1157,13065,473,13065,473,0,208
"Boone County, Indiana",72483,387,19621,749,19469,770,152,189,42770,1017,40305,1660,2465,1137,10092,485,10092,485,0,208
"Carroll County, Indiana",20345,142,4443,774,4081,829,362,362,10759,739,9790,837,969,603,5143,733,5143,733,0,208
"Cass County, Indiana",36822,494,9067,481,8864,523,203,251,20794,830,18547,993,2247,879,6961,589,6563,336,398,507
"Clark County, Indiana",121253,1196,28483,578,27244,1102,1239,983,72310,1346,65981,1990,6329,1667,20460,517,20182,718,278,323
"Clay County, Indiana",25900,333,6091,235,5953,292,138,159,15012,403,14017,612,995,607,4797,215,4797,215,0,208
"Clinton County, Indiana",32559,324,9313,239,8490,625,823,600,17982,357,15406,1059,2576,973,5264,242,5264,242,0,208
"Daviess County, Indiana",32979,288,10506,514,5154,1294,5352,1304,17063,675,13065,1220,3998,1085,5410,401,5375,404,35,57
"Dearborn County, Indiana",50300,467,12071,535,11883,601,188,241,28974,449,27034,933,1940,787,9255,257,9255,257,0,208
"Decatur County, Indiana",25871,310,6328,162,6328,162,0,208,15057,358,14760,431,297,234,4486,251,4450,251,36,63
"DeKalb County, Indiana",42771,375,10990,486,10191,784,799,617,24559,600,22033,1116,2526,972,7222,365,7222,365,0,208
"Delaware County, Indiana",110047,704,23610,1087,23249,1140,361,335,67868,1145,61702,1757,6166,1553,18569,449,18501,449,68,87
"Dubois County, Indiana",42924,216,11319,409,11163,477,156,202,24032,461,22801,966,1231,773,7573,251,7573,251,0,208
"Elkhart County, Indiana",204819,705,59222,911,51971,2983,7251,2861,114722,1480,95518,3514,19204,2977,30875,823,30082,901,793,413
"Fayette County, Indiana",20389,2777,4065,1212,3972,1212,93,106,11404,1810,10961,1766,443,329,4920,728,4920,728,0,208
"Floyd County, Indiana",79379,608,18893,572,18222,866,671,644,47888,686,44368,1259,3520,1186,12598,357,12598,357,0,208
"Franklin County, Indiana",22804,81,5294,256,5009,285,285,286,13031,246,12205,566,826,506,4479,213,4479,213,0,208
"Fulton County, Indiana",19211,2179,4076,902,3779,860,297,344,10558,1477,9208,1265,1350,591,4577,533,4552,536,25,43
"Gibson County, Indiana",32415,252,8493,489,7839,891,654,733,18280,525,16932,664,1348,607,5642,291,5642,291,0,208
"Grant County, Indiana",65574,589,14749,321,14302,639,447,580,38107,755,33349,1326,4758,1188,12718,526,12718,526,0,208
"Greene County, Indiana",30476,266,7153,393,6410,582,743,484,17283,455,15028,961,2255,958,6040,153,6016,155,24,41
"Hamilton County, Indiana",353062,1704,98492,1475,93818,2392,4674,2502,207569,2058,192841,4466,14728,4085,47001,973,46869,984,132,160
"Hancock County, Indiana",81318,254,20330,1274,19627,1356,703,617,47238,1474,43017,1885,4221,1580,13750,928,13671,949,79,138
"Harrison County, Indiana",39306,310,8768,474,8120,747,648,591,23489,475,22046,903,1443,701,7049,230,7049,230,0,208
"Hendricks County, Indiana",176461,1231,46499,685,43613,1667,2886,1797,104843,1737,98985,2526,5858,1811,25119,1108,24986,1130,133,224
"Henry County, Indiana",45464,495,10321,281,10227,313,94,99,26365,501,23912,930,2453,835,8778,305,8778,305,0,208
"Howard County, Indiana",81801,1177,19521,793,18910,984,611,634,46470,1111,43083,1444,3387,972,15810,392,15810,392,0,208
"Huntington County, Indiana",36389,290,8463,379,8003,492,460,328,21629,489,19624,797,2005,724,6297,158,6290,154,7,15
"Jackson County, Indiana",45420,494,11443,336,10170,974,1273,942,26415,721,22338,1174,4077,1066,7562,350,7256,327,306,352
"Jasper County, Indiana",32738,318,7522,766,7503,765,19,33,19359,749,18412,1125,947,718,5857,190,5857,190,0,208
"Jay County, Indiana",20027,202,4864,202,4651,393,213,321,11261,360,10820,443,441,284,3902,283,3902,283,0,208
"Jefferson County, Indiana",32050,773,7387,564,6743,798,644,548,18806,855,17335,1024,1471,828,5857,178,5797,202,60,94
"Jennings County, Indiana",27151,357,6731,1397,5897,1281,834,1101,15731,1405,13704,1956,2027,1152,4689,1084,4689,1084,0,208
"Johnson County, Indiana",162068,937,41915,885,40531,1261,1384,1009,96210,1599,88476,2764,7734,2294,23943,1012,23821,1033,122,212
"Knox County, Indiana",35219,409,7759,493,7704,497,55,75,21013,590,18457,963,2556,993,6447,447,6447,447,0,208
"Kosciusko County, Indiana",79483,509,19670,621,17980,1076,1690,899,45913,885,39425,1706,6488,1730,13900,520,13818,539,82,143
"LaGrange County, Indiana",40394,149,13747,280,6534,1241,7213,1292,21026,309,12875,1334,8151,1315,5621,197,5147,361,474,311
"Lake County, Indiana",494397,1235,121145,1109,113132,2777,8013,2610,288591,1420,254755,3916,33836,3921,84661,689,84421,721,240,204
"LaPorte County, Indiana",104509,1200,25864,643,25302,761,562,381,58390,1113,54919,1470,3471,1003,20255,402,20226,392,29,50
"Lawrence County, Indiana",44506,325,10700,728,10363,871,337,506,24993,762,22972,980,2021,776,8813,260,8813,260,0,208
"Madison County, Indiana",125835,830,29098,529,28413,602,685,429,73002,888,63193,1878,9809,1786,23735,531,23703,530,32,56
"Marion County, Indiana",961925,1278,251445,1475,239492,3309,11953,3099,586768,1830,516636,7202,70132,7120,123712,847,122306,1066,1406,682
"Marshall County, Indiana",45509,427,11969,371,10113,1038,1856,929,25440,527,22083,873,3357,801,8100,342,8053,353,47,78
"Miami County, Indiana",33896,566,8020,328,7746,423,274,273,19759,589,17755,896,2004,785,6117,271,6117,271,0,208
"Monroe County, Indiana",139009,591,29943,2417,29215,2375,728,520,89764,2544,82523,2846,7241,1798,19302,372,19013,475,289,377
"Montgomery County, Indiana",37577,490,8886,139,8783,149,103,108,21963,504,20716,664,1247,581,6728,133,6728,133,0,208
"Morgan County, Indiana",71131,536,16773,523,15808,834,965,606,41980,669,37857,1456,4123,1381,12378,308,12378,308,0,208
"Noble County, Indiana",46698,355,12449,378,10374,894,2075,840,26500,576,22588,1158,3912,1107,7749,372,7749,372,0,208
"Owen County, Indiana",21238,209,4885,705,4453,775,432,398,13088,794,11582,1148,1506,890,3265,742,3214,716,51,84
"Porter County, Indiana",172981,642,39596,804,39007,935,589,399,102911,1320,97417,2287,5494,1863,30474,747,30432,749,42,72
"Posey County, Indiana",24930,163,5979,349,5868,384,111,115,14056,324,13715,466,341,326,4895,136,4895,136,0,208
"Putnam County, Indiana",34289,686,7419,488,7055,432,364,347,20547,880,18566,1149,1981,825,6323,561,6323,561,0,208
"Randolph County, Indiana",24112,187,5765,259,5714,279,51,85,13545,285,12758,447,787,343,4802,173,4802,173,0,208
"Ripley County, Indiana",28694,251,7169,293,7135,278,34,67,16373,360,14627,844,1746,739,5152,118,5145,117,7,12
"St. Joseph County, Indiana",269874,676,67673,609,63324,1692,4349,1619,158063,962,143005,2422,15058,2264,44138,623,43751,643,387,298
"Scott County, Indiana",23528,2212,5650,1611,5650,1611,0,208,13534,1562,13002,1523,532,405,4344,982,4344,982,0,208
"Shelby County, Indiana",44391,403,10464,706,10318,752,146,174,26403,748,23877,1358,2526,1081,7524,266,7524,266,0,208
"Spencer County, Indiana",19632,116,4738,346,4541,364,197,202,10860,386,10175,540,685,302,4034,160,4034,160,0,208
"Starke County, Indiana",23372,208,5767,480,5712,490,55,88,12972,426,12068,662,904,454,4633,208,4633,208,0,208
"Steuben County, Indiana",34431,195,7564,602,7564,602,0,208,19476,580,18035,916,1441,694,7391,268,7391,268,0,208
"Sullivan County, Indiana",18217,1845,4430,971,4400,974,30,54,9946,1347,8400,1321,1546,612,3841,582,3841,582,0,208
"Tippecanoe County, Indiana",185639,936,43923,1393,41746,1638,2177,1318,119735,1800,109746,2626,9989,1928,21981,735,21981,735,0,208
"Vanderburgh County, Indiana",177298,883,41238,745,39910,1026,1328,743,105662,1097,95864,2539,9798,2309,30398,450,30398,450,0,208
"Vigo County, Indiana",102610,1023,24113,1040,23746,1059,367,316,61479,1508,54883,2059,6596,1594,17018,282,17018,282,0,208
"Wabash County, Indiana",29781,445,6811,414,6418,656,393,458,17144,607,15848,838,1296,685,5826,361,5794,365,32,58
"Warrick County, Indiana",63884,260,16030,941,15558,959,472,393,36275,902,34441,1276,1834,840,11579,600,11579,600,0,208
"Washington County, Indiana",27722,358,6752,226,6201,427,551,362,15977,391,13755,915,2222,903,4993,110,4932,149,61,99
"Wayne County, Indiana",64897,935,15499,535,14803,646,696,362,37556,916,33867,1406,3689,1073,11842,412,11829,414,13,22
"Wells County, Indiana",27682,220,7022,294,6593,496,429,446,15883,340,13754,821,2129,728,4777,192,4777,192,0,208
"White County, Indiana",24486,161,6117,274,5912,370,205,219,13442,287,11333,537,2109,543,4927,155,4885,144,42,64
"Whitley County, Indiana",34119,328,8743,602,8622,604,121,140,18973,543,17073,1192,1900,1237,6403,257,6403,257,0,208
"Benton County, Iowa",25494,81,6538,306,6219,410,319,296,14268,322,13466,583,802,489,4688,121,4688,121,0,170
"Black Hawk County, Iowa",129351,417,31381,736,30644,930,737,581,75617,878,70005,1665,5612,1626,22353,383,22353,383,0,170
"Boone County, Iowa",26018,473,5841,521,5414,559,427,425,15388,298,14679,479,709,361,4789,209,4789,209,0,170
"Bremer County, Iowa",24791,239,6409,383,6340,405,69,123,13671,366,13309,523,362,326,4711,199,4711,199,0,170
"Buchanan County, Iowa",20454,176,5527,148,5098,620,429,597,11245,194,10616,441,629,361,3682,72,3682,72,0,170
"Buena Vista County, Iowa",20509,199,6183,407,6075,466,108,102,11222,381,10531,590,691,402,3104,248,3104,248,0,170
"Carroll County, Iowa",20451,117,5251,296,5145,324,106,157,11053,317,10453,441,600,299,4147,114,4138,116,9,16
"Cerro Gordo County, Iowa",42301,313,9601,450,9402,525,199,220,23485,428,21336,988,2149,911,9215,328,9215,328,0,170
"Clinton County, Iowa",45877,333,12196,646,12196,646,0,170,24819,606,23132,916,1687,675,8862,217,8862,217,0,170
"Dallas County, Iowa",103344,259,28279,721,26271,1586,2008,1355,62782,760,60109,1531,2673,1321,12283,280,12283,280,0,170
"Des Moines County, Iowa",38022,239,8178,785,8178,785,0,170,21600,979,20009,1128,1591,803,8244,722,8228,720,16,27
"Dubuque County, Iowa",97573,595,23710,496,23542,552,168,241,55597,749,52973,1114,2624,872,18266,466,18173,423,93,108
"Fayette County, Iowa",18949,107,4450,333,4256,355,194,194,10578,345,9837,404,741,353,3921,81,3906,83,15,27
"Henry County, Iowa",19349,550,4750,380,4569,445,181,227,10798,575,10225,585,573,307,3801,166,3790,168,11,19
"Jasper County, Iowa",35982,594,8259,424,7978,567,281,356,20618,555,19565,733,1053,578,7105,294,7105,294,0,170
"Johnson County, Iowa",153263,871,33563,1170,32561,1299,1002,828,100035,1572,93515,2464,6520,2036,19665,653,19365,533,300,392
"Jones County, Iowa",19703,825,4830,309,4732,349,98,123,10503,798,10095,811,408,343,4370,262,4370,262,0,170
"Lee County, Iowa",32047,833,7036,460,6965,493,71,100,18518,633,17540,794,978,494,6493,225,6456,232,37,57
"Linn County, Iowa",227198,806,55139,1165,54501,1232,638,359,134651,1264,128213,2334,6438,2012,37408,715,37214,694,194,279
"Mahaska County, Iowa",21712,146,5471,353,5238,379,233,352,12275,466,11505,754,770,469,3966,293,3966,293,0,170
"Marion County, Iowa",33199,108,8273,605,8180,640,93,153,18822,666,18239,714,583,354,6104,320,6104,320,0,170
"Marshall County, Iowa",38759,700,10254,145,9580,525,674,501,21922,463,18905,979,3017,1020,6583,657,6583,657,0,170
"Muscatine County, Iowa",42018,374,10531,206,10531,206,0,170,24023,581,22826,653,1197,535,7464,417,7439,422,25,48
"Plymouth County, Iowa",25402,132,6953,452,6630,339,323,250,13805,463,12569,665,1236,416,4644,80,4644,80,0,170
"Polk County, Iowa",489966,1951,127126,1219,124712,1588,2414,1036,296443,2325,277009,3815,19434,3005,66397,584,66332,592,65,77
"Pottawattamie County, Iowa",92569,571,22655,708,21798,725,857,582,52750,976,47253,1599,5497,1187,17164,524,17164,524,0,170
"Scott County, Iowa",172827,549,43823,740,42450,1315,1373,1128,100344,1062,93868,1999,6476,1631,28660,479,28660,479,0,170
"Sioux County, Iowa",35545,160,10793,515,9210,1110,1583,986,19301,502,18035,741,1266,680,5451,159,5451,159,0,170
"Story County, Iowa",98943,421,20992,1140,20696,1145,296,242,64972,1213,61554,1711,3418,1175,12979,469,12808,505,171,216
"Wapello County, Iowa",34906,274,8464,282,8401,295,63,122,19764,412,18533,887,1231,789,6678,390,6678,390,0,170
"Warren County, Iowa",52925,260,13918,535,13814,552,104,103,30400,653,29965,687,435,301,8607,406,8579,399,28,50
"Washington County, Iowa",22045,212,6043,284,5890,377,153,258,11863,315,10859,482,1004,465,4139,155,4139,155,0,170
"Webster County, Iowa",35361,679,8592,301,7690,740,902,616,19536,820,17684,1101,1852,745,7233,505,7207,502,26,32
"Winneshiek County, Iowa",19716,114,4007,253,4007,253,0,170,11370,278,10886,340,484,259,4339,178,4303,203,36,59
"Woodbury County, Iowa",104468,665,29578,682,28782,772,796,523,59632,1065,52157,1598,7475,1381,15258,521,15258,521,0,170
"Barton County, Kansas",24844,259,7122,785,7050,776,72,125,13064,834,10724,1218,2340,1049,4658,286,4658,286,0,187
"Butler County, Kansas",64786,693,17821,584,17513,621,308,253,36277,883,32888,1181,3389,945,10688,448,10688,448,0,187
"Cherokee County, Kansas",18964,93,4450,694,3873,784,577,331,10842,778,8630,866,2212,679,3672,760,3672,760,0,187
"Cowley County, Kansas",33327,477,8547,643,8067,767,480,486,18978,575,16005,825,2973,858,5802,516,5705,522,97,175
"Crawford County, Kansas",38715,232,9542,1124,9299,1132,243,239,23272,1170,19874,1169,3398,1227,5901,279,5901,279,0,187
"Douglas County, Kansas",118673,481,25705,1752,24422,1794,1283,586,76860,1896,67547,2441,9313,1819,16108,564,16108,564,0,187
"Ellis County, Kansas",28624,143,6953,679,6831,670,122,136,17091,719,15359,1088,1732,755,4580,176,4580,176,0,187
"Finney County, Kansas",37937,182,12020,333,10983,405,1037,487,21876,457,18079,1292,3797,1229,4041,293,4041,293,0,187
"Ford County, Kansas",33766,269,10456,341,8389,1342,2067,1315,19745,570,15387,1557,4358,1485,3565,491,3565,491,0,187
"Franklin County, Kansas",25774,171,6656,494,6648,489,8,15,14651,489,12318,747,2333,711,4467,269,4467,269,0,187
"Geary County, Kansas",31587,1078,11002,414,10465,696,537,555,17781,1169,13269,1443,4512,1311,2804,422,2774,424,30,54
"Harvey County, Kansas",33177,311,8548,312,7901,448,647,476,17604,633,15041,1184,2563,1027,7025,572,7025,572,0,187
"Johnson County, Kansas",609156,909,152554,1410,148146,2162,4408,1506,363550,1576,335987,3414,27563,3317,93052,540,92935,561,117,136
"Labette County, Kansas",19560,212,5382,800,5084,829,298,327,10282,1008,9008,1140,1274,562,3896,423,3896,423,0,187
"Leavenworth County, Kansas",75828,1416,20062,370,19677,580,385,377,43109,1358,39246,2141,3863,1359,12657,505,12532,513,125,196
"Lyon County, Kansas",31732,243,7425,475,7121,527,304,289,19788,529,17424,1102,2364,830,4519,204,4478,214,41,68
"McPherson County, Kansas",29316,534,7718,803,7583,716,135,188,16384,761,15146,1022,1238,618,5214,546,5208,545,6,12
"Miami County, Kansas",33839,425,8744,738,8286,797,458,380,19119,738,16441,1309,2678,1098,5976,258,5976,258,0,187
"Montgomery County, Kansas",30698,281,7443,573,7084,721,359,434,17437,660,15038,1162,2399,916,5818,344,5818,344,0,187
"Pottawatomie County, Kansas",25564,104,8000,264,7754,288,246,192,13858,353,12349,809,1509,718,3706,212,3706,212,0,187
"Reno County, Kansas",58857,910,13935,463,13759,491,176,154,32666,937,27802,1620,4864,1433,12256,529,12256,529,0,187
"Riley County, Kansas",66709,1506,14700,1375,14199,1492,501,515,44553,1951,41303,1862,3250,1482,7456,579,7380,587,76,137
"Saline County, Kansas",53044,510,12858,669,12761,731,97,173,30928,768,26012,1662,4916,1486,9258,588,9223,589,35,60
"Sedgwick County, Kansas",517015,1535,138661,1380,130419,2795,8242,2673,299129,1827,250036,4881,49093,4488,79225,443,78915,536,310,300
"Seward County, Kansas",21605,150,7016,858,6496,914,520,451,12675,915,9201,1127,3474,1027,1914,788,1914,788,0,187
"Shawnee County, Kansas",174354,1271,43041,904,39608,2050,3433,1678,97728,1120,84837,2390,12891,2317,33585,658,33494,670,91,149
"Sumner County, Kansas",22036,226,6388,464,6093,542,295,247,11419,452,10146,733,1273,594,4229,285,4229,285,0,187
"Wyandotte County, Kansas",165977,644,47777,593,44518,1064,3259,1029,96640,869,69749,2600,26891,2489,21560,266,20858,481,702,439
"Allen County, Kentucky",20674,216,5066,1015,3913,996,1153,965,11736,990,10821,1270,915,616,3872,749,3872,749,0,208
"Anderson County, Kentucky",23948,186,5026,927,4922,968,104,193,14493,791,13820,856,673,447,4429,651,4429,651,0,208
"Barren County, Kentucky",44056,300,10812,495,10606,578,206,316,25539,564,22157,989,3382,963,7705,397,7705,397,0,208
"Bell County, Kentucky",24367,2773,5550,1343,5404,1327,146,186,15498,1969,14210,2032,1288,849,3319,1062,3319,1062,0,208
"Boone County, Kentucky",136296,826,36244,560,35289,1023,955,829,81128,1033,77413,1595,3715,1268,18924,340,18800,373,124,201
"Bourbon County, Kentucky",20138,188,4814,859,4814,859,0,208,11674,813,11108,862,566,398,3650,862,3650,862,0,208
"Boyd County, Kentucky",46431,605,10496,681,10245,709,251,231,26044,902,24478,1131,1566,840,9891,319,9891,319,0,208
"Boyle County, Kentucky",29474,649,7238,487,7065,525,173,211,16838,694,14790,999,2048,842,5398,324,5398,324,0,208
"Bullitt County, Kentucky",82559,530,18290,481,18290,481,0,208,50462,745,47679,1002,2783,769,13807,225,13792,227,15,26
"Calloway County, Kentucky",37330,356,7999,538,7661,577,338,270,22805,631,20992,851,1813,693,6526,151,6526,151,0,208
"Campbell County, Kentucky",91750,777,20036,463,19680,618,356,380,56376,919,53029,1406,3347,1184,15338,241,15300,224,38,63
"Carter County, Kentucky",26142,373,5060,1048,5007,1038,53,94,14489,1207,13374,1189,1115,539,6593,1192,6521,1182,72,127
"Christian County, Kentucky",61987,1294,20271,284,18567,1270,1704,1238,33081,1192,28835,1552,4246,1315,8635,405,8635,405,0,208
"Clark County, Kentucky",36541,436,8650,290,8627,282,23,43,21330,460,20596,623,734,426,6561,366,6561,366,0,208
"Clay County, Kentucky",20017,1851,5531,1101,5384,1147,147,177,11400,1551,10544,1742,856,571,3086,890,3086,890,0,208
"Daviess County, Kentucky",100946,977,25970,440,24531,926,1439,803,57231,1121,53467,1385,3764,1172,17745,477,17745,477,0,208
"Fayette County, Kentucky",317873,1100,73026,1011,70446,1381,2580,1060,200303,1485,180242,3217,20061,2850,44544,759,44124,827,420,476
"Floyd County, Kentucky",34763,429,8056,660,7666,812,390,467,19592,772,17372,1266,2220,814,7115,422,7115,422,0,208
"Franklin County, Kentucky",50707,963,11009,1136,10672,1173,337,335,30223,735,27875,965,2348,732,9475,450,9475,450,0,208
"Grant County, Kentucky",24970,382,6758,861,6728,870,30,58,14920,918,13724,1066,1196,712,3292,906,3292,906,0,208
"Graves County, Kentucky",36254,211,10523,543,9810,709,713,366,19021,585,17351,686,1670,599,6710,264,6645,286,65,115
"Grayson County, Kentucky",25985,647,6494,378,6469,380,25,46,14733,715,13600,927,1133,633,4758,192,4758,192,0,208
"Greenup County, Kentucky",35273,240,8287,198,7591,552,696,497,19451,273,18166,586,1285,508,7535,227,7535,227,0,208
"Hardin County, Kentucky",105400,1444,28523,497,27370,990,1153,899,60164,1734,53947,2211,6217,1793,16713,829,16713,829,0,208
"Harlan County, Kentucky",25796,385,6592,498,6541,500,51,71,14561,581,13125,869,1436,737,4643,173,4643,173,0,208
"Henderson County, Kentucky",43572,713,10775,457,10671,445,104,155,24226,940,23260,1250,966,766,8571,580,8571,580,0,208
"Hopkins County, Kentucky",44310,546,10941,623,10422,881,519,545,25134,790,23708,896,1426,608,8235,299,8235,299,0,208
"Jefferson County, Kentucky",769712,2008,179403,1196,172890,2314,6513,2055,461055,2263,424091,4857,36964,4537,129254,627,128760,676,494,319
"Jessamine County, Kentucky",53218,327,13389,365,12621,861,768,801,31352,579,28892,1215,2460,1123,8477,474,8237,500,240,270
"Johnson County, Kentucky",21051,2802,4885,1254,4623,1201,262,287,13541,1998,11938,1885,1603,716,2625,716,2625,716,0,208
"Kenton County, Kentucky",168059,1013,40702,412,40141,493,561,320,102107,1143,96065,1489,6042,1189,25250,423,25195,417,55,90
"Knox County, Kentucky",29533,313,7314,1426,6986,1411,328,360,15289,1248,14612,1325,677,694,6930,1360,6930,1360,0,208
"Laurel County, Kentucky",61602,1221,15014,566,14190,901,824,580,36076,1212,31058,1832,5018,1666,10512,397,10512,397,0,208
"Letcher County, Kentucky",21048,293,4143,1082,4143,1082,0,208,12385,1260,11490,1326,895,968,4520,950,4520,950,0,208
"Lincoln County, Kentucky",24087,219,7102,870,7002,879,100,136,12935,1028,11716,1203,1219,679,4050,899,4012,899,38,66
"Logan County, Kentucky",27470,212,7036,335,5682,1045,1354,948,15601,442,13270,903,2331,869,4833,166,4833,166,0,208
"McCracken County, Kentucky",66468,757,15456,400,15199,448,257,202,37394,812,35077,1220,2317,1015,13618,529,13492,454,126,197
"Madison County, Kentucky",93783,619,22174,1187,21628,1158,546,555,58540,1326,54501,1630,4039,1011,13069,351,13028,359,41,70
"Marshall County, Kentucky",31221,333,6600,457,6600,457,0,208,17595,586,16793,824,802,460,7026,336,7026,336,0,208
"Meade County, Kentucky",29233,372,8771,929,8504,926,267,301,16005,1115,14933,1104,1072,597,4457,852,4457,852,0,208
"Mercer County, Kentucky",20947,2291,3978,1107,3711,998,267,367,12670,1473,11547,1316,1123,562,4299,705,4299,705,0,208
"Montgomery County, Kentucky",27922,317,6297,898,6023,972,274,413,16721,1073,14930,1308,1791,1056,4904,893,4904,893,0,208
"Muhlenberg County, Kentucky",29436,695,6969,544,6792,562,177,269,16423,794,14902,1228,1521,950,6044,540,5980,540,64,103
"Nelson County, Kentucky",46839,199,11002,568,10837,665,165,198,28196,642,25666,1241,2530,1133,7641,299,7641,299,0,208
"Ohio County, Kentucky",23455,155,5628,363,5542,387,86,148,13622,414,12719,534,903,648,4205,151,4205,151,0,208
"Oldham County, Kentucky",65118,848,17811,636,17710,651,101,166,37925,997,37029,1105,896,476,9382,224,9362,218,20,39
"Perry County, Kentucky",27430,479,6956,1523,6956,1523,0,208,16617,1560,16231,1492,386,311,3857,1084,3857,1084,0,208
"Pike County, Kentucky",56678,620,12464,478,12464,478,0,208,33129,758,30742,1075,2387,866,11085,160,11015,189,70,86
"Pulaski County, Kentucky",64520,589,15597,669,15031,569,566,611,36732,594,33645,1569,3087,1409,12191,486,12191,486,0,208
"Rowan County, Kentucky",24513,466,6571,1252,5941,1243,630,552,14691,1298,13364,1372,1327,756,3251,889,3251,889,0,208
"Scott County, Kentucky",57963,207,15449,463,14603,824,846,718,35072,621,32788,1078,2284,990,7442,341,7442,341,0,208
"Shelby County, Kentucky",47464,579,11108,417,10357,992,751,848,28492,603,24181,1492,4311,1504,7864,274,7864,274,0,208
"Taylor County, Kentucky",25908,391,5530,1125,5530,1125,0,208,15179,886,13675,986,1504,922,5199,895,5199,895,0,208
"Warren County, Kentucky",136001,650,35124,1108,34373,1210,751,636,83558,1314,76437,2241,7121,2004,17319,481,17216,472,103,175
"Wayne County, Kentucky",19294,280,4108,938,4108,938,0,208,11269,1002,10884,1025,385,319,3917,988,3917,988,0,208
"Whitley County, Kentucky",36444,459,10524,649,10496,634,28,48,20240,701,18765,991,1475,777,5680,158,5680,158,0,208
"Woodford County, Kentucky",26821,257,6855,831,6855,831,0,208,14228,962,13920,986,308,186,5738,892,5691,869,47,81
"Acadia Parish, Louisiana",56626,278,15465,607,15156,629,309,371,32053,755,28359,1420,3694,1280,9108,521,9108,521,0,230
"Allen Parish, Louisiana",18410,1756,6070,665,5610,660,460,297,9211,1358,7527,1175,1684,911,3129,447,3085,451,44,74
"Ascension Parish, Louisiana",127526,641,35150,787,33834,1099,1316,693,75348,1387,67730,2007,7618,2157,17028,858,17028,858,0,230
"Assumption Parish, Louisiana",20481,247,4485,921,4485,921,0,230,12275,814,9023,1016,3252,1076,3721,790,3721,790,0,230
"Avoyelles Parish, Louisiana",36363,1295,10048,319,9262,823,786,722,19643,1408,17041,1752,2602,924,6672,480,6635,483,37,51
"Beauregard Parish, Louisiana",35663,445,9011,383,8639,529,372,410,20630,554,18456,1016,2174,883,6022,324,5876,384,146,263
"Bossier Parish, Louisiana",121855,1612,33850,861,32672,1059,1178,599,69270,1653,58983,2748,10287,2116,18735,529,18735,529,0,230
"Caddo Parish, Louisiana",228813,3782,56931,955,56262,969,669,518,129922,3960,116442,4472,13480,2288,41960,541,41948,542,12,19
"Calcasieu Parish, Louisiana",203019,1565,52078,943,50175,1315,1903,1230,119084,1778,105162,3249,13922,3213,31857,474,31417,659,440,444
"De Soto Parish, Louisiana",26762,196,6878,338,6565,424,313,253,14823,573,14294,613,529,322,5061,580,5061,580,0,230
"East Baton Rouge Parish, Louisiana",449397,1913,110121,1526,106878,1728,3243,1067,270839,2417,240856,4373,29983,3722,68437,788,67698,896,739,515
"Evangeline Parish, Louisiana",30748,656,8307,158,8242,184,65,82,17626,720,14322,1337,3304,1137,4815,368,4815,368,0,230
"Grant Parish, Louisiana",17928,1337,4359,655,4359,655,0,230,10289,827,7968,1182,2321,861,3280,323,3280,323,0,230
"Iberia Parish, Louisiana",68165,1129,18763,657,18169,739,594,600,38078,1221,34484,1410,3594,1106,11324,351,11265,354,59,104
"Iberville Parish, Louisiana",26803,1105,6713,410,6306,404,407,303,15211,1237,12915,1775,2296,1336,4879,834,4879,834,0,230
"Jefferson Parish, Louisiana",429936,1121,100915,1114,93095,2320,7820,2057,249983,1523,215639,4181,34344,4038,79038,325,78407,526,631,413
"Jefferson Davis Parish, Louisiana",31740,452,8333,1100,8333,1100,0,230,18122,1161,15200,1401,2922,1115,5285,477,5285,477,0,230
"Lafayette Parish, Louisiana",242120,968,60204,1006,58472,1194,1732,628,148093,1359,132097,3044,15996,2649,33823,583,33776,563,47,90
"Lafourche Parish, Louisiana",96731,569,23226,344,22942,516,284,384,56361,724,53182,1170,3179,1104,17144,494,17112,497,32,55
"Lincoln Parish, Louisiana",47531,475,10371,626,9861,735,510,490,30559,604,28049,1136,2510,1106,6601,281,6601,281,0,230
"Livingston Parish, Louisiana",144606,953,39365,1427,36279,1967,3086,1589,85846,1865,76297,2953,9549,2533,19395,774,19395,774,0,230
"Morehouse Parish, Louisiana",24146,563,6100,165,6100,165,0,230,12983,638,11282,745,1701,619,5063,254,5063,254,0,230
"Natchitoches Parish, Louisiana",36376,773,9368,651,9316,668,52,69,20646,918,18469,899,2177,567,6362,276,6308,268,54,89
"Orleans Parish, Louisiana",371682,1188,78261,1053,75134,1493,3127,1117,232385,1467,208864,2943,23521,2624,61036,433,60370,543,666,356
"Ouachita Parish, Louisiana",156871,618,40838,651,38496,1104,2342,1058,91463,794,81639,2323,9824,2224,24570,498,23857,1125,713,1062
"Plaquemines Parish, Louisiana",21870,679,4360,1263,4193,1245,167,283,13635,1209,12585,1226,1050,662,3875,884,3875,884,0,230
"Pointe Coupee Parish, Louisiana",20228,188,5512,1288,5322,1296,190,285,10493,1332,9050,1244,1443,918,4223,1177,4223,1177,0,230
"Rapides Parish, Louisiana",125657,1105,32888,601,31157,908,1731,863,71810,1295,61589,2565,10221,2338,20959,418,20929,422,30,53
"Richland Parish, Louisiana",19809,1939,5454,760,5180,834,274,392,10947,1538,9727,1439,1220,649,3408,850,3408,850,0,230
"Sabine Parish, Louisiana",21886,193,5853,462,5686,483,167,216,11724,526,10459,636,1265,522,4309,224,4309,224,0,230
"St. Bernard Parish, Louisiana",44136,238,13390,1242,13241,1260,149,219,25894,1183,22999,1496,2895,1072,4852,995,4760,1011,92,159
"St. Charles Parish, Louisiana",51570,586,14113,722,13734,769,379,288,29581,1220,27311,1238,2270,924,7876,734,7708,747,168,192
"St. James Parish, Louisiana",19555,256,4523,791,4381,849,142,203,11081,892,9847,926,1234,663,3951,811,3951,811,0,230
"St. John the Baptist Parish, Louisiana",41728,302,10826,603,10826,603,0,230,24479,960,22442,1085,2037,1193,6423,663,6423,663,0,230
"St. Landry Parish, Louisiana",81238,733,23065,677,20890,1916,2175,1909,44473,911,38680,1941,5793,1782,13700,336,13653,342,47,73
"St. Martin Parish, Louisiana",51156,373,12546,524,11879,751,667,608,30248,889,27401,1375,2847,1236,8362,605,8301,591,61,106
"St. Mary Parish, Louisiana",47571,601,11828,346,11694,356,134,136,27094,783,24117,947,2977,980,8649,466,8532,498,117,177
"St. Tammany Parish, Louisiana",265289,1464,68217,929,65237,1574,2980,1275,149060,1863,134718,3297,14342,2758,48012,369,47822,526,190,317
"Tangipahoa Parish, Louisiana",133588,1384,34804,916,33777,1041,1027,1117,77617,2081,68945,2999,8672,2325,21167,816,21100,826,67,113
"Terrebonne Parish, Louisiana",106880,1833,28672,934,27938,1238,734,563,61399,2072,55654,2439,5745,1845,16809,1042,16385,1081,424,462
"Union Parish, Louisiana",20380,1044,2810,1105,2087,874,723,748,11807,1342,10750,1513,1057,479,5763,1115,5763,1115,0,230
"Vermilion Parish, Louisiana",56627,434,15114,486,14844,572,270,324,33073,669,30368,1215,2705,1030,8440,478,8440,478,0,230
"Vernon Parish, Louisiana",41156,1019,12561,532,12233,519,328,222,22647,952,20242,949,2405,778,5948,205,5789,307,159,227
"Washington Parish, Louisiana",43153,986,11405,494,10718,813,687,709,23331,998,21262,1186,2069,922,8417,176,8417,176,0,230
"Webster Parish, Louisiana",35165,1325,8422,247,8316,216,106,124,19554,1383,18402,1335,1152,499,7189,627,7094,648,95,126
"West Baton Rouge Parish, Louisiana",26883,821,6463,1513,6338,1525,125,213,16230,1738,13850,1919,2380,1610,4190,1105,4190,1105,0,230
"Androscoggin County, Maine",109157,1074,23975,477,23100,914,875,852,65325,861,60467,1632,4858,1335,19857,787,19857,787,0,182
"Aroostook County, Maine",65941,410,13027,498,12275,642,752,398,36883,587,32845,1011,4038,971,16031,415,15998,420,33,54
"Cumberland County, Maine",301917,1255,58848,787,57355,1348,1493,1085,184986,1537,175243,2506,9743,1978,58083,917,58083,917,0,182
"Franklin County, Maine",29547,267,5558,229,5346,344,212,265,17153,272,15119,638,2034,575,6836,286,6836,286,0,182
"Hancock County, Maine",55654,402,9421,659,8382,773,1039,637,31666,736,27886,1053,3780,894,14567,318,14551,320,16,27
"Kennebec County, Maine",122589,728,24514,427,23312,890,1202,738,73585,684,67760,1391,5825,1459,24490,625,24433,651,57,94
"Knox County, Maine",39641,1437,7403,361,7390,364,13,25,21339,1024,18994,1414,2345,867,10899,241,10899,241,0,182
"Lincoln County, Maine",35563,233,6132,300,5938,379,194,219,19002,383,16978,786,2024,766,10429,305,10429,305,0,182
"Oxford County, Maine",58012,352,10947,379,10633,444,314,186,34197,412,30843,910,3354,873,12868,341,12868,341,0,182
"Penobscot County, Maine",151125,764,29645,723,28102,1290,1543,1054,92892,1015,84072,2174,8820,1881,28588,544,28531,559,57,97
"Sagadahoc County, Maine",37004,143,7116,514,6795,640,321,374,21214,472,20187,626,1027,503,8674,352,8674,352,0,182
"Somerset County, Maine",49995,460,9132,268,8791,377,341,308,29770,471,27114,1094,2656,1095,11093,297,11047,313,46,81
"Waldo County, Maine",39753,196,7884,382,7100,672,784,565,22269,420,19695,734,2574,745,9600,246,9600,246,0,182
"Washington County, Maine",30751,235,6528,333,6176,427,352,287,16433,383,14254,653,2179,522,7790,213,7790,213,0,182
"York County, Maine",213523,631,40798,657,38977,1056,1821,926,127052,965,118293,2201,8759,1871,45673,487,45656,490,17,29
"Allegany County, Maryland",61818,2172,12472,817,12403,784,69,118,36368,1326,34202,1602,2166,869,12978,510,12978,510,0,216
"Anne Arundel County, Maryland",566629,4057,137735,1506,134752,1983,2983,1168,338742,4175,314726,5616,24016,3902,90152,565,89346,848,806,543
"Baltimore County, Maryland",842167,1422,198217,1464,187968,3783,10249,3321,495992,1746,463537,4362,32455,3797,147958,699,147586,709,372,259
"Calvert County, Maryland",92071,655,22697,676,22167,868,530,566,53532,1099,51500,1177,2032,752,15842,511,15842,511,0,216
"Caroline County, Maryland",33042,276,8494,346,7790,529,704,660,19076,478,17183,706,1893,507,5472,224,5472,224,0,216
"Carroll County, Maryland",171567,921,39877,532,39495,633,382,310,101865,1167,97662,1733,4203,1293,29825,536,29761,556,64,109
"Cecil County, Maryland",102773,551,23857,540,22433,1106,1424,948,61822,806,57558,1304,4264,1205,17094,463,16839,516,255,263
"Charles County, Maryland",165172,1294,42250,1435,41186,1585,1064,781,101490,1803,94600,2176,6890,1843,21432,500,21388,508,44,76
"Dorchester County, Maryland",32105,433,6340,922,5837,1078,503,478,17984,1011,16205,1171,1779,715,7781,434,7531,436,250,342
"Frederick County, Maryland",276201,1198,68803,703,66734,1216,2069,1042,166343,1467,154218,2736,12125,2267,41055,653,40773,698,282,315
"Garrett County, Maryland",28249,280,5631,375,5527,420,104,167,15907,455,15093,562,814,378,6711,188,6666,202,45,76
"Harford County, Maryland",260499,1025,61680,878,58400,1686,3280,1413,154937,1477,146425,2629,8512,2226,43882,785,43845,789,37,59
"Howard County, Maryland",330151,1935,84200,846,80762,1504,3438,1413,197626,1618,187978,2700,9648,2243,48325,817,48140,810,185,236
"Montgomery County, Maryland",1046271,2696,254243,1221,247311,1918,6932,1546,620042,2862,561993,5604,58049,4892,171986,744,169490,1127,2496,996
"Prince George's County, Maryland",945504,2865,223660,1325,207203,3619,16457,3383,585361,3169,503829,6586,81532,5944,136483,762,134147,1065,2336,925
"Queen Anne's County, Maryland",50423,400,11200,329,10713,425,487,195,29110,617,26508,1025,2602,975,10113,489,9921,475,192,292
"St. Mary's County, Maryland",110404,1400,28128,580,27847,632,281,301,66890,1775,63184,2422,3706,1876,15386,778,15386,778,0,216
"Somerset County, Maryland",21018,1491,5316,657,5282,655,34,64,11587,1457,10818,1461,769,547,4115,932,4115,932,0,216
"Talbot County, Maryland",37377,190,6625,867,6326,879,299,467,19512,911,17763,912,1749,665,11240,349,11190,365,50,86
"Washington County, Maryland",144656,7506,35272,632,33279,1112,1993,877,82976,7125,76167,5962,6809,2318,26408,508,26152,558,256,159
"Wicomico County, Maryland",102744,868,25619,1198,23143,1493,2476,1224,60859,1387,56361,1805,4498,1476,16266,317,16266,317,0,216
"Worcester County, Maryland",52459,602,9457,411,9018,530,439,457,28258,766,26186,1095,2072,705,14744,417,14675,415,69,88
"Baltimore city, Maryland",567379,2908,123677,1329,117697,2776,5980,2558,360350,2862,334680,3710,25670,2822,83352,758,82893,927,459,379
"Barnstable County, Massachusetts",230090,614,35369,572,34683,787,686,515,120943,1055,115324,1809,5619,1607,73778,944,73698,948,80,94
"Berkshire County, Massachusetts",126658,711,22815,965,22594,1024,221,206,73426,1105,71253,1339,2173,889,30417,585,30275,606,142,212
"Bristol County, Massachusetts",574846,1647,125632,1148,124425,1254,1207,603,350655,1726,335991,3052,14664,2526,98559,912,98496,925,63,105
"Dukes County, Massachusetts",20470,2331,3977,954,3977,954,0,218,11234,1657,10615,1753,619,677,5259,835,5259,835,0,218
"Essex County, Massachusetts",800543,1355,179410,1544,177423,1592,1987,864,480013,2016,462865,3307,17148,2681,141120,683,140360,882,760,482
"Franklin County, Massachusetts",70257,415,12601,703,12410,749,191,190,40789,835,39619,1012,1170,427,16867,486,16851,488,16,26
"Hampden County, Massachusetts",456993,1601,104725,1233,102081,1897,2644,1544,273995,1915,261329,3280,12666,2355,78273,758,78152,789,121,140
"Hampshire County, Massachusetts",160378,423,31018,1582,30558,1420,460,417,99301,1635,97750,1659,1551,553,30059,469,29986,481,73,100
"Middlesex County, Massachusetts",1600639,1667,338984,1824,334952,2629,4032,1759,1012092,2408,983568,4315,28524,3534,249563,1040,248249,1243,1314,749
"Norfolk County, Massachusetts",717305,1459,159113,1446,157998,1702,1115,853,435341,1993,420437,3705,14904,3202,122851,1128,122271,1186,580,430
"Plymouth County, Massachusetts",524907,2777,118242,1079,116495,1432,1747,975,309219,2906,298658,3552,10561,1986,97446,978,96790,1100,656,483
"Suffolk County, Massachusetts",766037,1497,142768,2646,140733,2962,2035,1252,526315,2871,505432,4089,20883,3426,96954,922,96015,1089,939,580
"Worcester County, Massachusetts",851986,1903,190348,1812,188283,1963,2065,880,523886,2432,506253,4151,17633,3212,137752,914,137290,970,462,369
"Allegan County, Michigan",119884,510,30177,468,29351,595,826,538,69078,651,64658,1527,4420,1318,20629,439,20518,453,111,156
"Alpena County, Michigan",28690,193,5701,318,5632,335,69,86,15921,380,14504,715,1417,612,7068,182,7050,185,18,32
"Antrim County, Michigan",23660,241,4047,224,3761,289,286,228,12841,255,11885,472,956,390,6772,225,6767,225,5,10
"Barry County, Michigan",62479,527,14046,375,13239,755,807,678,36666,550,34041,956,2625,832,11767,431,11767,431,0,181
"Bay County, Michigan",102180,541,20449,714,20113,822,336,328,59833,888,55746,1435,4087,1007,21898,490,21898,490,0,181
"Berrien County, Michigan",152069,720,34645,616,33833,810,812,523,85941,966,77965,1687,7976,1344,31483,496,31361,515,122,144
"Branch County, Michigan",43135,1103,10920,120,9475,847,1445,883,24144,901,21678,1147,2466,775,8071,282,8054,282,17,29
"Calhoun County, Michigan",132511,577,31977,865,30419,1305,1558,1030,76822,967,70860,1690,5962,1465,23712,633,23712,633,0,181
"Cass County, Michigan",51369,166,10854,244,10600,281,254,210,29058,505,26875,854,2183,604,11457,381,11457,381,0,181
"Charlevoix County, Michigan",25888,199,4597,138,4469,165,128,121,14481,265,13541,369,940,279,6810,272,6810,272,0,181
"Cheboygan County, Michigan",25554,173,4351,227,4190,257,161,142,13998,314,12683,555,1315,418,7205,152,7108,194,97,131
"Chippewa County, Michigan",33926,726,7519,391,7274,431,245,336,19707,696,17859,724,1848,456,6700,226,6684,229,16,26
"Clare County, Michigan",30805,286,6422,230,5808,505,614,461,16779,326,14703,661,2076,602,7604,201,7591,198,13,21
"Clinton County, Michigan",79028,314,18119,312,17873,357,246,179,46518,517,44886,777,1632,606,14391,382,14378,384,13,23
"Delta County, Michigan",36412,327,7551,320,7426,368,125,160,19852,407,18189,658,1663,572,9009,231,9009,231,0,181
"Dickinson County, Michigan",25453,236,5106,371,5106,371,0,181,14311,396,13439,636,872,567,6036,121,6036,121,0,181
"Eaton County, Michigan",108168,508,23247,338,22336,622,911,535,63382,703,58868,1204,4514,1122,21539,522,21523,520,16,27
"Emmet County, Michigan",33688,403,6661,289,6008,465,653,388,19153,491,17240,715,1913,659,7874,274,7854,275,20,34
"Genesee County, Michigan",402204,1343,95102,1058,93866,1135,1236,506,234183,1804,214549,3458,19634,2977,72919,685,72632,772,287,347
"Gladwin County, Michigan",25325,162,4978,297,4630,458,348,359,13533,297,12430,437,1103,351,6814,140,6814,140,0,181
"Grand Traverse County, Michigan",95125,397,19655,736,19305,814,350,359,55480,830,52987,1487,2493,1399,19990,346,19990,346,0,181
"Gratiot County, Michigan",37225,694,9327,479,8798,557,529,347,21106,639,19194,644,1912,546,6792,373,6792,373,0,181
"Hillsdale County, Michigan",45314,311,10151,284,8446,1660,1705,1612,25815,328,22860,758,2955,717,9348,176,9348,176,0,181
"Houghton County, Michigan",36924,352,9470,905,9287,870,183,203,20914,912,19220,1201,1694,648,6540,426,6540,426,0,181
"Huron County, Michigan",30964,364,5987,201,5879,205,108,108,16708,356,15417,490,1291,398,8269,309,8259,310,10,17
"Ingham County, Michigan",282409,920,62679,1451,60260,1542,2419,801,179293,1600,165316,2780,13977,2408,40437,641,40437,641,0,181
"Ionia County, Michigan",64311,580,16337,568,15707,669,630,330,37730,620,34555,972,3175,797,10244,324,10244,324,0,181
"Iosco County, Michigan",25190,126,4487,339,4221,401,266,218,13111,330,11974,550,1137,444,7592,244,7562,247,30,38
"Isabella County, Michigan",64385,360,13314,784,11281,1329,2033,1249,42427,793,38729,972,3698,815,8644,213,8637,214,7,14
"Jackson County, Michigan",152044,1026,36127,533,35126,977,1001,769,87182,1059,78962,1930,8220,1571,28735,571,28321,888,414,552
"Kalamazoo County, Michigan",259214,895,60122,989,59008,1009,1114,673,159185,1346,150175,2031,9010,1763,39907,483,39784,512,123,146
"Kent County, Michigan",653334,1163,164392,1490,160261,1903,4131,1648,395986,1847,368130,3739,27856,3134,92956,865,92858,881,98,123
"Lapeer County, Michigan",86633,669,18702,566,18120,599,582,353,50912,592,47707,1180,3205,1030,17019,487,17019,487,0,181
"Leelanau County, Michigan",22438,177,3917,335,3841,348,76,78,11203,332,10925,357,278,143,7318,197,7318,197,0,181
"Lenawee County, Michigan",96142,776,21701,567,21274,651,427,353,55475,736,52048,1112,3427,829,18966,509,18966,509,0,181
"Livingston County, Michigan",194398,521,42770,506,42256,626,514,442,115094,540,110467,1320,4627,1107,36534,403,36534,403,0,181
"Macomb County, Michigan",869981,1284,191533,1128,187120,1902,4413,1571,525189,1474,486337,4045,38852,3997,153259,854,152450,940,809,459
"Manistee County, Michigan",24118,515,4639,378,4578,401,61,92,12977,439,12175,519,802,317,6502,305,6502,305,0,181
"Marquette County, Michigan",64406,585,12834,415,12739,405,95,116,38652,650,36853,996,1799,838,12920,334,12920,334,0,181
"Mason County, Michigan",29211,163,6254,325,6135,322,119,161,15576,381,14566,446,1010,412,7381,85,7342,107,39,68
"Mecosta County, Michigan",39773,222,7898,407,7592,520,306,290,24219,452,22731,637,1488,498,7656,204,7649,204,7,12
"Menominee County, Michigan",23063,205,4528,208,4440,225,88,68,12665,240,11907,388,758,340,5870,203,5870,203,0,181
"Midland County, Michigan",82985,463,18460,513,18314,524,146,141,48396,813,45795,993,2601,798,16129,443,15983,524,146,169
"Monroe County, Michigan",154161,430,34109,545,33386,738,723,591,90066,711,85912,1169,4154,1110,29986,478,29886,506,100,162
"Montcalm County, Michigan",64623,818,15171,198,14423,452,748,406,37454,818,33239,1154,4215,1122,11998,259,11903,299,95,149
"Muskegon County, Michigan",172798,861,42229,544,40637,1190,1592,968,98752,999,92527,1871,6225,1758,31817,367,31655,421,162,180
"Newaygo County, Michigan",49756,753,11818,265,10794,667,1024,617,28094,731,24901,997,3193,740,9844,257,9782,256,62,74
"Oakland County, Michigan",1264385,1650,272864,1335,266627,2004,6237,1503,768351,2258,729436,4721,38915,4118,223170,451,222070,898,1100,667
"Oceana County, Michigan",26596,255,5970,331,5692,363,278,232,14885,454,13190,617,1695,692,5741,347,5720,353,21,35
"Ogemaw County, Michigan",20506,183,3984,283,3870,313,114,143,10896,327,10196,467,700,368,5626,98,5626,98,0,181
"Osceola County, Michigan",22679,357,5197,239,3939,679,1258,649,12587,339,11114,544,1473,480,4895,114,4895,114,0,181
"Otsego County, Michigan",25133,149,5500,508,5144,619,356,300,14219,496,13201,741,1018,594,5414,190,5414,190,0,181
"Ottawa County, Michigan",297832,449,76895,1195,75746,1263,1149,593,174817,1502,167442,2306,7375,1706,46120,802,46120,802,0,181
"Roscommon County, Michigan",23485,157,3531,547,3497,555,34,66,12086,569,10711,540,1375,472,7868,165,7868,165,0,181
"Saginaw County, Michigan",186411,1086,43834,862,42326,1508,1508,1344,106232,1149,98466,1876,7766,1631,36345,540,36212,546,133,139
"St. Clair County, Michigan",158780,855,34351,414,33147,985,1204,879,93580,784,86664,1737,6916,1665,30849,521,30741,516,108,135
"St. Joseph County, Michigan",60255,422,15394,216,14181,608,1213,612,34034,522,29280,1241,4754,1117,10827,196,10796,199,31,37
"Sanilac County, Michigan",40230,213,9113,172,8305,603,808,584,22013,240,19796,613,2217,554,9104,218,9077,224,27,28
"Shiawassee County, Michigan",67571,267,15356,353,15132,388,224,185,39205,441,36567,686,2638,770,13010,339,13010,339,0,181
"Tuscola County, Michigan",52212,413,10875,399,10763,411,112,122,30294,254,28375,482,1919,498,11043,263,11043,263,0,181
"Van Buren County, Michigan",75170,367,18205,391,17208,924,997,803,43144,608,37349,1041,5795,1110,13821,377,13716,399,105,158
"Washtenaw County, Michigan",363855,3696,76810,1323,74770,1530,2040,964,232396,3870,220804,4311,11592,1981,54649,409,54576,414,73,86
"Wayne County, Michigan",1764465,1953,438412,1540,426466,3139,11946,2825,1043543,2440,956135,4926,87408,5126,282510,810,280573,910,1937,590
"Wexford County, Michigan",33714,174,8082,238,7541,494,541,465,18882,228,17081,646,1801,606,6750,171,6750,171,0,181
"Anoka County, Minnesota",364400,1084,91499,886,90325,1035,1174,543,218060,1545,203974,2900,14086,2397,54841,710,54738,714,103,119
"Becker County, Minnesota",34865,162,8683,196,8296,338,387,303,18602,271,17334,462,1268,369,7580,294,7572,297,8,14
"Beltrami County, Minnesota",45696,326,11572,896,10129,1226,1443,731,26531,963,23181,1230,3350,1150,7593,485,7583,486,10,18
"Benton County, Minnesota",40839,336,10964,360,10633,333,331,230,24581,449,23613,702,968,490,5294,224,5294,224,0,157
"Blue Earth County, Minnesota",68690,225,14983,502,14794,518,189,127,43665,749,41633,1040,2032,704,10042,468,10033,468,9,15
"Brown County, Minnesota",25505,263,6232,383,5635,666,597,656,13985,341,12923,705,1062,552,5288,312,5288,312,0,157
"Carlton County, Minnesota",34735,602,8471,154,8104,263,367,225,20000,565,18497,503,1503,388,6264,284,6251,286,13,24
"Carver County, Minnesota",108479,155,29658,426,29054,676,604,419,64442,537,62827,886,1615,731,14379,354,14379,354,0,157
"Cass County, Minnesota",30421,213,6805,210,6246,313,559,276,15438,341,14213,437,1225,301,8178,169,8152,181,26,45
"Chisago County, Minnesota",56142,468,13008,248,12771,317,237,201,33749,491,31298,1113,2451,1039,9385,232,9385,232,0,157
"Clay County, Minnesota",65174,341,17661,478,17317,566,344,271,38522,659,36721,927,1801,739,8991,556,8991,556,0,157
"Crow Wing County, Minnesota",66518,273,14900,433,13597,864,1303,727,36158,535,32010,1252,4148,1198,15460,308,15452,309,8,13
"Dakota County, Minnesota",439685,729,112518,882,110775,1361,1743,891,261105,1193,246360,2996,14745,2889,66062,705,65980,718,82,96
"Dodge County, Minnesota",20859,83,5740,219,5514,312,226,218,12003,231,11254,396,749,281,3116,96,3116,96,0,157
"Douglas County, Minnesota",38717,243,8851,356,8614,409,237,238,20983,468,20141,588,842,363,8883,201,8883,201,0,157
"Fillmore County, Minnesota",20992,153,5498,146,4931,262,567,246,11125,209,10226,303,899,223,4369,160,4369,160,0,157
"Freeborn County, Minnesota",30363,270,7091,305,6944,354,147,145,16325,389,15002,547,1323,490,6947,251,6942,250,5,8
"Goodhue County, Minnesota",47159,362,10620,242,9771,629,849,551,27083,351,24043,896,3040,842,9456,256,9456,256,0,157
"Hennepin County, Minnesota",1259379,1173,291774,1491,282642,2830,9132,2678,781067,1839,733912,4925,47155,4487,186538,856,185466,1122,1072,628
"Hubbard County, Minnesota",21505,180,4978,331,4962,330,16,28,10995,364,10098,488,897,453,5532,209,5517,213,15,26
"Isanti County, Minnesota",41795,125,9708,376,9407,616,301,409,24782,452,22031,921,2751,927,7305,339,7297,341,8,15
"Itasca County, Minnesota",44368,307,9719,320,9654,324,65,78,23794,353,22722,495,1072,424,10855,238,10848,235,7,14
"Kandiyohi County, Minnesota",43074,549,11361,642,10683,874,678,487,23320,808,21266,1317,2054,1074,8393,599,8393,599,0,157
"Le Sueur County, Minnesota",28705,94,6977,267,6484,496,493,391,16557,246,15425,526,1132,442,5171,129,5171,129,0,157
"Lyon County, Minnesota",24987,173,6710,655,6190,664,520,293,13800,606,12381,714,1419,485,4477,526,4450,515,27,47
"McLeod County, Minnesota",36481,162,8400,199,8102,499,298,458,20795,395,19274,676,1521,655,7286,327,7240,340,46,79
"Martin County, Minnesota",19708,116,4200,296,3960,339,240,188,10720,346,10354,427,366,214,4788,217,4781,217,7,13
"Meeker County, Minnesota",23099,191,5557,267,5438,314,119,183,12525,283,11940,386,585,246,5017,341,4863,281,154,228
"Mille Lacs County, Minnesota",26521,235,6572,269,6446,237,126,112,15351,288,14268,493,1083,378,4598,193,4598,193,0,157
"Morrison County, Minnesota",33578,195,8258,94,8039,143,219,127,18543,184,17412,421,1131,387,6777,225,6763,225,14,20
"Mower County, Minnesota",39532,378,9689,490,9446,524,243,204,22904,488,21758,642,1146,358,6939,201,6899,214,40,68
"Nicollet County, Minnesota",34074,208,8510,750,8229,782,281,286,19872,801,19318,900,554,338,5692,306,5692,306,0,157
"Nobles County, Minnesota",21606,321,6780,419,5653,788,1127,893,11569,435,9236,754,2333,755,3257,382,3251,381,6,10
"Olmsted County, Minnesota",161731,784,43134,843,41447,1374,1687,1086,93798,1372,90492,1737,3306,1084,24799,720,24799,720,0,157
"Otter Tail County, Minnesota",59356,215,13510,310,13160,338,350,145,31569,375,29110,750,2459,583,14277,303,14277,303,0,157
"Pine County, Minnesota",28001,913,5719,185,5547,238,172,148,15569,893,14210,869,1359,402,6713,279,6713,279,0,157
"Polk County, Minnesota",30209,343,8059,550,6878,729,1181,499,16539,668,14937,994,1602,716,5611,414,5575,422,36,63
"Ramsey County, Minnesota",539628,935,132406,905,129035,1373,3371,1049,326561,1171,304417,3109,22144,2952,80661,606,79708,850,953,531
"Rice County, Minnesota",64319,1150,15441,548,15194,566,247,165,38402,1250,35323,1652,3079,1150,10476,423,10412,429,64,114
"St. Louis County, Minnesota",196119,875,39956,768,39295,863,661,417,116576,1002,110761,1487,5815,1172,39587,355,39541,361,46,55
"Scott County, Minnesota",151636,546,41156,516,39870,906,1286,807,93135,1028,88468,1896,4667,1682,17345,886,17345,886,0,157
"Sherburne County, Minnesota",97361,814,26194,708,25858,761,336,288,59242,1096,56367,1438,2875,1109,11925,438,11925,438,0,157
"Stearns County, Minnesota",157824,582,40522,1048,39832,1154,690,369,93408,1114,88361,1674,5047,1392,23894,639,23885,639,9,14
"Steele County, Minnesota",36953,183,9728,294,9437,376,291,245,20387,434,19024,753,1363,621,6838,326,6838,326,0,157
"Todd County, Minnesota",25089,95,6470,259,5015,620,1455,560,13153,262,11781,452,1372,316,5466,88,5379,155,87,130
"Wabasha County, Minnesota",21360,175,4939,262,4676,281,263,197,11675,294,10856,472,819,385,4746,200,4704,211,42,69
"Washington County, Minnesota",269500,1100,69423,892,68131,1439,1292,985,157308,1422,150855,1900,6453,1459,42769,632,42692,646,77,127
"Winona County, Minnesota",49249,211,10117,534,9408,837,709,719,30248,510,28791,818,1457,668,8884,386,8851,385,33,64
"Wright County, Minnesota",144203,413,40998,756,39761,919,1237,1210,83789,1077,79074,2493,4715,2158,19416,524,19394,527,22,39
"Adams County, Mississippi",26215,2351,5900,1060,5591,1079,309,325,14350,1530,12300,1503,2050,768,5965,804,5965,804,0,233
"Alcorn County, Mississippi",33646,515,8310,670,8085,690,225,236,18887,735,16245,1061,2642,766,6449,535,6449,535,0,233
"Bolivar County, Mississippi",29630,619,7879,290,7760,350,119,202,17101,819,14435,1212,2666,912,4650,554,4650,554,0,233
"Coahoma County, Mississippi",20611,184,6112,303,5706,315,406,277,11059,386,8950,740,2109,707,3440,246,3440,246,0,233
"Copiah County, Mississippi",27860,136,6678,1022,5356,1130,1322,809,15746,1052,11485,1382,4261,1312,5436,877,5436,877,0,233
"DeSoto County, Mississippi",187343,1052,49738,932,48209,1266,1529,834,111842,1366,97255,2833,14587,2553,25763,628,25371,666,392,273
"Forrest County, Mississippi",76947,703,18797,706,17768,1005,1029,806,47476,1097,38219,2028,9257,1931,10674,570,10519,600,155,179
"George County, Mississippi",24116,1052,6024,899,5934,874,90,163,14734,1122,12961,1562,1773,1176,3358,942,3358,942,0,233
"Grenada County, Mississippi",21185,254,6359,1292,6359,1292,0,233,12148,1013,9352,1400,2796,777,2678,822,2678,822,0,233
"Hancock County, Mississippi",45883,231,8894,469,7912,1104,982,904,27657,573,22591,1973,5066,1782,9332,353,9332,353,0,233
"Harrison County, Mississippi",201047,1666,52314,1010,47957,2504,4357,2379,115166,2001,92305,3663,22861,3473,33567,628,33567,628,0,233
"Hinds County, Mississippi",221325,839,55890,511,53204,1136,2686,1109,130687,920,101788,2920,28899,2980,34748,333,34659,364,89,140
"Itawamba County, Mississippi",23618,249,6608,959,6544,968,64,110,12906,1013,11688,1212,1218,567,4104,1132,4036,1140,68,111
"Jackson County, Mississippi",141310,1377,33794,672,30977,1883,2817,1796,84162,1405,67695,3233,16467,3054,23354,461,23327,463,27,45
"Jones County, Mississippi",66185,478,17191,925,15808,1399,1383,1146,37400,1408,28742,2547,8658,1890,11594,1194,11594,1194,0,233
"Lafayette County, Mississippi",56332,607,14615,1447,14157,1521,458,421,33469,1620,28003,2166,5466,1739,8248,620,8248,620,0,233
"Lamar County, Mississippi",64454,738,17211,645,16168,1120,1043,978,38272,920,32594,2082,5678,2197,8971,503,8971,503,0,233
"Lauderdale County, Mississippi",68643,1185,17893,802,17323,1202,570,634,38176,1543,32529,1828,5647,1587,12574,259,12524,268,50,87
"Leake County, Mississippi",20609,785,5947,1196,5407,1256,540,591,11568,1303,9714,1403,1854,757,3094,842,3094,842,0,233
"Lee County, Mississippi",82011,600,21594,885,19738,1394,1856,1057,48051,928,41139,1656,6912,1448,12366,398,12366,398,0,233
"Leflore County, Mississippi",27061,314,8291,441,7599,736,692,493,14639,561,10329,1073,4310,1126,4131,382,4131,382,0,233
"Lincoln County, Mississippi",34630,239,8184,1480,7461,1546,723,717,20116,1343,17130,1642,2986,1658,6330,1203,6330,1203,0,233
"Lowndes County, Mississippi",56032,880,14211,587,13324,854,887,807,32354,766,25918,1805,6436,1732,9467,329,9467,329,0,233
"Madison County, Mississippi",109054,378,27431,1283,25884,1431,1547,1106,66084,1315,55628,2490,10456,2181,15539,321,15416,274,123,173
"Marion County, Mississippi",23348,1486,4714,1278,4434,1333,280,411,14569,1803,10836,2116,3733,1436,4065,1151,4065,1151,0,233
"Marshall County, Mississippi",32479,478,7339,1068,7250,1072,89,158,18787,1375,15992,1656,2795,1156,6353,1083,6353,1083,0,233
"Monroe County, Mississippi",33571,269,8038,593,7875,682,163,273,19233,744,17364,881,1869,758,6300,365,6300,365,0,233
"Neshoba County, Mississippi",28489,375,8017,1405,7942,1356,75,191,16303,1523,13103,1790,3200,1397,4169,1029,4124,1034,45,80
"Newton County, Mississippi",19396,2355,5267,1795,3385,1286,1882,1489,10432,1487,7997,1723,2435,1089,3697,947,3683,946,14,23
"Oktibbeha County, Mississippi",51426,277,11063,727,10230,986,833,714,33964,875,29471,1984,4493,1737,6399,441,6399,441,0,233
"Panola County, Mississippi",32402,444,8685,579,7328,819,1357,879,17257,1005,14592,1068,2665,867,6460,601,6460,601,0,233
"Pearl River County, Mississippi",56135,205,14065,774,13111,906,954,813,31608,837,26031,2142,5577,1866,10462,525,10462,525,0,233
"Pike County, Mississippi",39479,311,11072,588,10272,1124,800,948,21533,1186,18906,1676,2627,1312,6874,991,6824,991,50,87
"Pontotoc County, Mississippi",31262,175,9333,660,8767,566,566,536,16911,779,12692,1489,4219,1399,5018,438,4850,421,168,216
"Prentiss County, Mississippi",24742,210,4589,999,4532,1020,57,109,15677,1368,13950,1395,1727,784,4476,1126,4476,1126,0,233
"Rankin County, Mississippi",152521,2347,37395,647,34282,1651,3113,1690,89019,2187,75937,2999,13082,2491,26107,868,25968,857,139,177
"Scott County, Mississippi",27355,343,7937,1195,7708,1243,229,429,14699,1250,12564,1539,2135,768,4719,908,4719,908,0,233
"Simpson County, Mississippi",24653,2652,7668,1833,6939,2025,729,754,12320,1538,9691,1584,2629,1156,4665,1075,4665,1075,0,233
"Sunflower County, Mississippi",22398,818,5635,205,5547,225,88,105,13411,908,10538,1178,2873,973,3352,431,3352,431,0,233
"Tate County, Mississippi",28007,234,7545,1147,7048,1025,497,367,16234,1275,12901,1542,3333,1215,4228,1110,4228,1110,0,233
"Tippah County, Mississippi",21443,204,6213,1134,6081,1093,132,151,12297,1027,10291,1098,2006,698,2933,814,2916,820,17,30
"Union County, Mississippi",27784,174,6714,1141,6341,1116,373,377,16189,1002,12894,1326,3295,1133,4881,778,4881,778,0,233
"Warren County, Mississippi",43131,392,10579,455,10439,421,140,187,24558,589,20675,1044,3883,1140,7994,322,7994,322,0,233
"Washington County, Mississippi",42902,890,11442,272,11111,330,331,173,24038,906,18957,1424,5081,1592,7422,132,7422,132,0,233
"Wayne County, Mississippi",19673,62,4238,1012,4102,998,136,223,12539,1233,10840,1339,1699,882,2896,789,2896,789,0,233
"Winston County, Mississippi",18690,2007,4618,901,4539,899,79,109,10427,1693,9559,1693,868,554,3645,750,3645,750,0,233
"Yazoo County, Mississippi",22569,2757,6402,1456,6020,1572,382,420,12294,1705,10424,1697,1870,875,3873,453,3803,470,70,81
"Adair County, Missouri",24924,233,5830,772,5738,788,92,181,15526,767,13821,1118,1705,726,3568,201,3568,201,0,198
"Audrain County, Missouri",24150,421,6044,316,5692,384,352,302,13674,529,11656,978,2018,790,4432,298,4432,298,0,198
"Barry County, Missouri",34513,241,8701,559,8549,586,152,162,18449,513,13919,1259,4530,1251,7363,365,7293,360,70,118
"Boone County, Missouri",184275,658,43769,1402,42286,1555,1483,833,116233,1593,103576,2659,12657,2106,24273,687,24141,709,132,229
"Buchanan County, Missouri",81679,703,20354,692,18718,1129,1636,1002,47898,959,39427,1637,8471,1652,13427,350,13427,350,0,198
"Butler County, Missouri",41483,354,10516,827,9087,1141,1429,1134,23029,958,18087,1497,4942,1180,7938,474,7938,474,0,198
"Callaway County, Missouri",42304,1051,10159,474,9494,612,665,700,24949,1067,20880,1315,4069,1200,7196,313,7196,313,0,198
"Camden County, Missouri",42935,426,8422,556,7809,671,613,498,22274,411,17178,1389,5096,1353,12239,205,12239,205,0,198
"Cape Girardeau County, Missouri",80949,613,18741,491,18127,680,614,454,48862,672,42567,1421,6295,1343,13346,563,13346,563,0,198
"Cass County, Missouri",108665,307,27374,487,26246,750,1128,593,62339,610,55543,1672,6796,1585,18952,465,18952,465,0,198
"Christian County, Missouri",91083,218,23354,677,21896,979,1458,701,52919,826,46501,1985,6418,1730,14810,354,14741,376,69,114
"Clay County, Missouri",253367,714,63965,713,60121,2020,3844,2048,152507,1416,138098,3101,14409,2723,36895,931,36573,949,322,312
"Clinton County, Missouri",20923,189,4715,237,4088,592,627,717,12517,366,10364,872,2153,814,3691,341,3691,341,0,198
"Cole County, Missouri",73045,1478,18394,1022,17445,1225,949,620,41615,1551,37154,1932,4461,1437,13036,412,12999,416,37,63
"Crawford County, Missouri",23900,2022,6897,957,6707,956,190,151,12695,1505,10732,1633,1963,785,4308,671,4308,671,0,198
"Dunklin County, Missouri",27009,413,7319,207,6892,421,427,381,14605,472,10719,952,3886,952,5085,187,5085,187,0,198
"Franklin County, Missouri",104128,576,24670,576,23232,1152,1438,1065,60138,805,53099,2353,7039,2153,19320,391,19320,391,0,198
"Greene County, Missouri",296621,1125,66378,1041,62501,1706,3877,1516,180758,1487,154281,3465,26477,3312,49485,540,49438,543,47,64
"Henry County, Missouri",22063,153,5251,344,4572,482,679,372,11858,332,9899,866,1959,900,4954,161,4954,161,0,198
"Howell County, Missouri",39554,234,10279,676,9438,841,841,528,21760,647,17481,1273,4279,1184,7515,284,7515,284,0,198
"Jackson County, Missouri",709892,1183,173059,1161,160178,3161,12881,2955,426317,1872,353999,4423,72318,4382,110516,912,109968,939,548,306
"Jasper County, Missouri",122413,394,31438,510,28584,1374,2854,1349,71769,705,58069,2364,13700,2098,19206,409,19206,409,0,198
"Jefferson County, Missouri",225810,581,54938,755,53640,767,1298,850,135085,1071,121221,2266,13864,2578,35787,581,35779,579,8,14
"Johnson County, Missouri",49221,1067,13427,627,13088,616,339,289,29710,1116,27236,1423,2474,789,6084,333,6084,333,0,198
"Laclede County, Missouri",35790,291,9453,845,8557,960,896,636,19346,950,15368,1447,3978,1388,6991,751,6991,751,0,198
"Lafayette County, Missouri",32428,203,7632,434,7219,386,413,387,18375,461,16515,763,1860,717,6421,319,6421,319,0,198
"Lawrence County, Missouri",37652,351,10498,454,9557,1194,941,985,20470,568,16054,1444,4416,1431,6684,242,6684,242,0,198
"Lincoln County, Missouri",60849,473,16197,442,14502,1264,1695,1179,35745,784,31029,1777,4716,1625,8907,463,8907,463,0,198
"McDonald County, Missouri",21710,2410,6495,1247,5908,1212,587,339,12290,1474,8872,1341,3418,953,2925,775,2925,775,0,198
"Marion County, Missouri",28120,244,6356,572,6356,572,0,198,16626,601,14130,1078,2496,853,5138,219,5138,219,0,198
"Miller County, Missouri",24623,170,6269,476,6091,494,178,216,13785,477,11740,1098,2045,841,4569,162,4569,162,0,198
"Morgan County, Missouri",22807,2422,6175,1226,4277,1521,1898,1564,12433,1548,8527,1432,3906,1276,4199,874,4199,874,0,198
"Newton County, Missouri",58920,257,14951,303,14276,665,675,650,33333,398,26819,1697,6514,1637,10636,332,10541,338,95,155
"Nodaway County, Missouri",20661,282,3982,389,3676,357,306,250,13488,446,12321,743,1167,547,3191,153,3191,153,0,198
"Pettis County, Missouri",42628,393,11272,269,9757,908,1515,875,24261,484,19096,1355,5165,1285,7095,377,6934,406,161,178
"Phelps County, Missouri",44195,562,10082,629,9502,630,580,339,26924,741,22681,1558,4243,1324,7189,403,7151,411,38,70
"Platte County, Missouri",107291,661,26820,586,25641,1044,1179,800,63870,932,56722,1834,7148,2022,16601,390,16601,390,0,198
"Polk County, Missouri",31516,379,7892,485,7539,575,353,357,18102,469,15283,985,2819,865,5522,115,5495,137,27,49
"Pulaski County, Missouri",41332,1447,11812,1283,9900,1893,1912,1698,23817,1502,18799,1855,5018,1782,5703,683,5703,683,0,198
"Randolph County, Missouri",22969,636,5713,293,5193,480,520,457,13554,566,12110,661,1444,563,3702,187,3702,187,0,198
"Ray County, Missouri",22809,224,5314,159,5172,231,142,154,13334,208,12360,505,974,457,4161,229,4156,230,5,9
"St. Charles County, Missouri",408347,723,97996,1089,94690,1611,3306,1259,244593,1296,230720,2697,13873,2482,65758,479,65636,525,122,145
"St. Francois County, Missouri",63169,788,15765,705,15251,825,514,446,36380,994,31566,1858,4814,1553,11024,480,11024,480,0,198
"St. Louis County, Missouri",987048,1243,232639,1573,225067,2568,7572,2213,571903,1863,522486,5522,49417,5172,182506,825,181687,1084,819,650
"Saline County, Missouri",22896,296,5935,727,5884,697,51,100,12813,689,12081,868,732,406,4148,427,4148,427,0,198
"Scott County, Missouri",37436,267,9273,122,8478,1035,795,1046,21251,230,16732,1103,4519,1087,6912,241,6897,241,15,26
"Stoddard County, Missouri",28095,190,6859,458,6446,634,413,380,15608,451,12768,1089,2840,1003,5628,238,5480,324,148,176
"Stone County, Missouri",31220,255,5318,318,5290,326,28,61,16189,298,13992,779,2197,695,9713,234,9525,288,188,191
"Taney County, Missouri",55939,296,12172,753,11643,706,529,473,30582,877,22632,1686,7950,1735,13185,557,13185,557,0,198
"Texas County, Missouri",23387,468,5501,424,5399,433,102,130,12890,629,9600,1144,3290,1059,4996,286,4685,445,311,345
"Vernon County, Missouri",19120,246,5196,269,3317,1069,1879,1097,10185,373,7634,839,2551,742,3739,216,3739,216,0,198
"Warren County, Missouri",36315,281,8785,616,8785,616,0,198,21003,644,19096,1043,1907,798,6527,250,6527,250,0,198
"Washington County, Missouri",22554,346,6188,542,5935,606,253,376,12476,530,9877,1226,2599,1138,3890,162,3890,162,0,198
"Webster County, Missouri",38912,689,11922,843,9656,1666,2266,1483,20950,1074,17617,1380,3333,1013,6040,174,6040,174,0,198
"St. Louis city, Missouri",289341,1167,56793,773,55615,1068,1178,525,189812,1398,159564,3678,30248,3729,42736,581,42469,646,267,278
"Cascade County, Montana",79996,977,20078,571,19441,719,637,384,43892,1123,38839,1687,5053,1391,16026,452,15979,460,47,75
"Flathead County, Montana",107715,308,24822,655,23324,1031,1498,889,60562,716,53111,1884,7451,1732,22331,364,22198,439,133,170
"Gallatin County, Montana",122440,270,25983,794,24996,1160,987,746,80172,884,74072,1880,6100,1658,16285,473,16220,486,65,80
"Lake County, Montana",31862,133,7352,307,6336,679,1016,600,17156,499,13926,895,3230,1007,7354,351,7271,363,83,120
"Lewis and Clark County, Montana",71583,375,15718,775,15639,797,79,138,41759,868,39223,1281,2536,1006,14106,368,13805,513,301,357
"Lincoln County, Montana",20492,2002,3814,953,3479,982,335,291,11062,1381,9375,1402,1687,688,5616,974,5534,972,82,81
"Missoula County, Montana",118741,543,23244,734,22640,836,604,340,75997,925,69998,1908,5999,1674,19500,351,19302,412,198,246
"Ravalli County, Montana",45790,110,8823,259,7716,740,1107,682,24969,442,21125,1312,3844,1270,11998,344,11998,344,0,184
"Silver Bow County, Montana",34769,348,8199,761,8065,734,134,187,19846,708,18114,1034,1732,656,6724,420,6724,420,0,184
"Yellowstone County, Montana",165028,863,40900,802,38315,1505,2585,1461,95020,1079,85621,2074,9399,1651,29108,703,29108,703,0,184
"Adams County, Nebraska",30807,227,8010,426,7850,395,160,170,17350,448,15958,818,1392,677,5447,247,5417,250,30,51
"Buffalo County, Nebraska",49724,417,12239,470,12108,479,131,119,29433,675,27774,978,1659,721,8052,498,7911,494,141,193
"Cass County, Nebraska",26698,196,6717,210,5295,1465,1422,1431,15083,315,14011,612,1072,544,4898,230,4886,234,12,22
"Dakota County, Nebraska",21038,231,7053,538,6750,597,303,389,11018,711,9953,872,1065,592,2967,578,2967,578,0,170
"Dawson County, Nebraska",23672,241,6646,132,6433,284,213,264,13103,380,11743,611,1360,477,3923,327,3923,327,0,170
"Dodge County, Nebraska",36681,143,9885,375,9507,478,378,297,20058,443,18146,779,1912,653,6738,260,6700,266,38,51
"Douglas County, Nebraska",578239,2061,156562,1174,148731,2263,7831,2044,343365,2228,303648,4605,39717,4129,78312,447,77466,591,846,422
"Gage County, Nebraska",21443,197,5064,397,4900,429,164,137,11734,416,10737,533,997,446,4645,348,4645,348,0,170
"Hall County, Nebraska",61483,427,17073,553,15235,1477,1838,1293,34624,738,27314,1930,7310,1935,9786,548,9648,604,138,184
"Lancaster County, Nebraska",318984,1519,78006,997,75011,1471,2995,1213,194148,1970,179865,2855,14283,2406,46830,880,46616,878,214,234
"Lincoln County, Nebraska",33783,399,8176,152,7598,634,578,632,18665,424,17351,890,1314,685,6942,327,6942,327,0,170
"Madison County, Nebraska",34818,310,9529,496,9140,553,389,355,19704,630,17951,850,1753,778,5585,290,5585,290,0,170
"Platte County, Nebraska",34015,189,9719,489,9638,487,81,99,18171,577,16686,743,1485,747,6125,364,6125,364,0,170
"Sarpy County, Nebraska",189154,881,53885,613,53122,673,763,443,111734,1351,103093,2448,8641,1893,23535,839,22966,772,569,564
"Saunders County, Nebraska",22616,171,6192,267,5850,373,342,371,12387,295,11036,690,1351,574,4037,159,3992,184,45,73
"Scotts Bluff County, Nebraska",35030,502,9347,343,8566,668,781,557,18966,668,15902,1081,3064,828,6717,328,6557,393,160,232
"Washington County, Nebraska",20753,196,4968,281,4805,323,163,151,11912,399,11168,551,744,451,3873,251,3868,251,5,12
"Churchill County, Nevada",24697,500,5388,1147,4793,1202,595,495,13901,1217,12365,1324,1536,925,5408,1178,5408,1178,0,221
"Clark County, Nevada",2266590,3456,544694,1821,495021,6423,49673,6199,1370192,3751,1137668,8233,232524,8061,351704,428,346796,1222,4908,1215
"Douglas County, Nevada",49714,184,8497,409,7672,605,825,537,25319,599,23309,941,2010,822,15898,469,15686,498,212,226
"Elko County, Nevada",53265,396,16179,1026,15231,1273,948,569,30047,1150,27432,1403,2615,996,7039,595,6981,598,58,90
"Lyon County, Nevada",60539,335,12839,432,11480,1094,1359,1034,34810,887,31439,1303,3371,1064,12890,621,12565,741,325,334
"Nye County, Nevada",53008,456,9266,890,7801,834,1465,921,27530,838,23536,1523,3994,1407,16212,840,16135,853,77,133
"Washoe County, Nevada",490086,1040,110074,1105,103316,2162,6758,2028,295757,1637,257241,4370,38516,4415,84255,508,83379,734,876,425
"Carson City, Nevada",56385,1183,12537,723,11852,934,685,562,32208,1339,27404,1658,4804,1121,11640,493,11640,493,0,221
"Belknap County, New Hampshire",63799,477,12301,812,11428,1002,873,713,36987,863,34141,1542,2846,1203,14511,425,14511,425,0,198
"Carroll County, New Hampshire",51154,227,8652,333,8551,386,101,129,27561,472,25300,1262,2261,1181,14941,341,14941,341,0,198
"Cheshire County, New Hampshire",76570,410,14806,399,14440,489,366,271,45975,477,41335,1306,4640,1183,15789,374,15789,374,0,198
"Coos County, New Hampshire",29133,777,5102,260,5074,261,28,33,16786,822,15000,1016,1786,575,7245,209,7232,210,13,15
"Grafton County, New Hampshire",91434,360,16606,769,16206,860,400,336,54691,861,51858,1091,2833,1044,20137,490,20077,490,60,80
"Hillsborough County, New Hampshire",421000,926,89286,1013,84529,2144,4757,2004,262224,1443,243062,3246,19162,2859,69490,1241,68633,1289,857,772
"Merrimack County, New Hampshire",152173,917,30952,670,30192,784,760,583,92631,994,86906,1466,5725,1323,28590,598,28494,601,96,100
"Rockingham County, New Hampshire",314404,700,62455,854,60444,1056,2011,787,192141,1195,181304,2663,10837,2321,59808,705,59654,718,154,175
"Strafford County, New Hampshire",130389,1242,25120,1083,23859,1375,1261,860,84608,1599,78852,1922,5756,1555,20661,510,20661,510,0,198
"Sullivan County, New Hampshire",42862,438,8149,328,7887,366,262,226,24866,590,22200,1020,2666,987,9847,447,9847,447,0,198
"Atlantic County, New Jersey",272504,846,60382,751,58065,1312,2317,1137,160348,1077,140434,2997,19914,2652,51774,386,51183,550,591,426
"Bergen County, New Jersey",948019,1151,211633,1511,204827,2327,6806,1900,569786,1843,517800,4945,51986,4732,166600,771,165054,1021,1546,782
"Burlington County, New Jersey",449191,2028,99921,1166,97697,1769,2224,1110,268687,2007,253761,3044,14926,2805,80583,529,80376,560,207,245
"Camden County, New Jersey",517792,1784,123675,949,118835,2033,4840,1750,311525,1506,284568,3393,26957,3571,82592,968,81913,1068,679,431
"Cape May County, New Jersey",94094,482,16181,233,15905,303,276,262,52172,619,47839,1792,4333,1696,25741,393,25718,395,23,38
"Cumberland County, New Jersey",141100,4295,38007,468,35853,1545,2154,1500,79744,4255,69830,3906,9914,2632,23349,493,23301,507,48,82
"Essex County, New Jersey",843053,2251,212529,1642,201628,2663,10901,2270,512916,2466,429841,6901,83075,6420,117608,853,116084,984,1524,634
"Gloucester County, New Jersey",303528,470,70188,1053,69335,1105,853,581,183040,1389,171821,2643,11219,2230,50300,863,50257,880,43,73
"Hudson County, New Jersey",698088,2472,148298,1576,141649,2871,6649,2488,463385,2760,394617,6611,68768,6294,86405,616,84220,1063,2185,823
"Hunterdon County, New Jersey",125473,2015,25088,656,24600,748,488,529,75272,1750,72289,1942,2983,1025,25113,564,24934,620,179,280
"Mercer County, New Jersey",381152,2320,88841,1307,86991,1545,1850,1137,232178,2560,213909,3913,18269,2833,60133,361,59776,439,357,313
"Middlesex County, New Jersey",853432,1719,199986,1483,194670,1871,5316,1331,519297,2141,471059,5182,48238,4799,134149,764,132270,1028,1879,856
"Monmouth County, New Jersey",640863,1111,141215,1081,134709,2577,6506,2341,381348,1594,355877,4207,25471,4194,118300,549,117902,629,398,286
"Morris County, New Jersey",506741,2280,113080,1164,108841,2138,4239,1885,305702,2099,285441,3648,20261,3276,87959,1387,87225,1441,734,441
"Ocean County, New Jersey",644050,1096,166986,1231,164414,1747,2572,1239,335555,1665,310090,4213,25465,3938,141509,659,141249,782,260,308
"Passaic County, New Jersey",515033,1100,129646,1313,124098,2108,5548,1666,307878,1455,256362,5476,51516,5039,77509,499,76250,778,1259,651
"Salem County, New Jersey",63811,1019,15049,426,14767,481,282,232,36864,1107,34362,1191,2502,662,11898,436,11898,436,0,222
"Somerset County, New Jersey",342915,757,76998,1084,75868,1258,1130,622,209973,926,197166,2742,12807,2705,55944,418,55173,569,771,407
"Sussex County, New Jersey",144309,787,29429,503,28263,826,1166,742,88420,685,82819,1661,5601,1408,26460,531,26460,531,0,222
"Union County, New Jersey",568534,816,139377,1242,131258,2789,8119,2362,346084,1392,289021,4720,57063,4705,83073,701,80979,1240,2094,1042
"Warren County, New Jersey",109958,352,22093,396,20564,1005,1529,956,67653,965,63036,1311,4617,1146,20212,890,19911,865,301,325
"Bernalillo County, New Mexico",666503,1797,151034,1755,140075,3424,10959,3330,399363,2479,348088,5967,51275,5440,116106,369,113989,908,2117,818
"Chaves County, New Mexico",63368,915,17532,832,16213,1326,1319,998,34938,1380,28520,2202,6418,1552,10898,667,10771,712,127,170
"Cibola County, New Mexico",27406,1527,8814,1114,8814,1114,0,224,13801,1573,12478,1581,1323,716,4791,1353,4791,1353,0,224
"Curry County, New Mexico",43325,1054,14141,752,13813,806,328,484,23833,1271,20797,1505,3036,1316,5351,400,5290,408,61,104
"Doña Ana County, New Mexico",217501,1772,56580,1440,54621,1967,1959,1149,124874,2407,100360,4372,24514,3927,36047,570,35568,721,479,376
"Eddy County, New Mexico",60411,724,16002,368,13541,2622,2461,2622,35537,1258,31431,2495,4106,2227,8872,817,8872,817,0,224
"Grant County, New Mexico",27467,310,6250,1530,6137,1496,113,191,13486,1299,12431,1382,1055,791,7731,1306,7731,1306,0,224
"Lea County, New Mexico",70939,3048,23089,1042,18891,1995,4198,1846,39754,2920,31377,3438,8377,2475,8096,632,7359,910,737,645
"Lincoln County, New Mexico",20280,270,4584,1132,4584,1132,0,224,9926,1282,8376,1524,1550,906,5770,1129,5770,1129,0,224
"Los Alamos County, New Mexico",20016,1950,5042,985,4834,951,208,249,11592,1410,11370,1444,222,267,3382,801,3313,799,69,111
"Luna County, New Mexico",23570,2216,6255,1677,6255,1677,0,224,12545,1552,9560,1686,2985,1254,4770,1165,4770,1165,0,224
"McKinley County, New Mexico",71392,454,20803,584,18808,847,1995,741,41742,862,29794,2158,11948,1787,8847,586,8636,599,211,134
"Otero County, New Mexico",63408,1298,16486,774,15801,1019,685,669,34931,1440,32077,1566,2854,1132,11991,398,11932,418,59,112
"Rio Arriba County, New Mexico",40161,44,9638,461,8468,628,1170,636,22288,512,17441,1353,4847,1164,8235,145,8235,145,0,224
"Sandoval County, New Mexico",151056,271,35311,768,33770,1120,1541,1018,86745,923,80481,1918,6264,1414,29000,558,28824,580,176,120
"San Juan County, New Mexico",119419,2185,32092,580,28449,1811,3643,1654,68213,2097,54505,2875,13708,2677,19114,207,18979,245,135,124
"San Miguel County, New Mexico",26650,508,5758,1218,5521,1161,237,352,14155,1075,12013,1416,2142,1253,6737,1158,6737,1158,0,224
"Santa Fe County, New Mexico",153221,1986,28014,787,27560,820,454,284,83898,2027,73941,3301,9957,2275,41309,391,41294,401,15,28
"Taos County, New Mexico",34417,191,6060,874,5769,895,291,406,17875,1014,15655,1574,2220,1265,10482,416,10482,416,0,224
"Valencia County, New Mexico",74896,1738,18884,1145,18734,1136,150,202,41461,2060,35742,2909,5719,2012,14551,963,14551,963,0,224
"Albany County, New York",309717,1582,62711,1345,61450,1571,1261,916,193411,1958,185053,2766,8358,2282,53595,816,53448,799,147,203
"Allegany County, New York",45605,240,10824,396,9948,730,876,667,25758,503,24515,670,1243,377,9023,314,8980,321,43,51
"Bronx County, New York",1403989,4526,367713,1882,356043,3638,11670,3329,846546,4422,754238,9063,92308,7845,189730,1651,187244,2097,2486,1400
"Broome County, New York",194249,1574,41778,734,40625,994,1153,676,115084,1806,109818,2170,5266,1536,37387,713,37278,715,109,145
"Cattaraugus County, New York",75343,426,17420,400,16182,871,1238,717,42824,577,39444,947,3380,824,15099,371,15054,377,45,77
"Cayuga County, New York",71237,1459,14941,513,14480,550,461,291,41220,1020,39224,1158,1996,634,15076,385,15058,380,18,31
"Chautauqua County, New York",124774,467,27330,862,25439,1409,1891,1161,71935,950,67874,1407,4061,1118,25509,422,25393,428,116,129
"Chemung County, New York",79207,1370,18117,457,17328,632,789,474,45315,1458,42367,1758,2948,1154,15775,456,15775,456,0,217
"Chenango County, New York",46025,213,10033,454,9922,455,111,109,26019,454,24482,921,1537,747,9973,277,9958,277,15,29
"Clinton County, New York",75446,1261,15638,632,15468,658,170,250,45837,1121,44058,1289,1779,704,13971,533,13971,533,0,217
"Columbia County, New York",60337,646,10195,413,10017,473,178,210,34847,728,33495,878,1352,575,15295,290,15214,304,81,105
"Cortland County, New York",45860,374,10503,626,10216,708,287,255,27795,682,26068,864,1727,661,7562,474,7562,474,0,217
"Delaware County, New York",44006,242,7811,599,7806,599,5,11,24987,635,23747,1050,1240,622,11208,260,11208,260,0,217
"Dutchess County, New York",289229,2067,59605,1148,58036,1261,1569,795,176350,1986,166590,2822,9760,2290,53274,564,53171,568,103,114
"Erie County, New York",941046,2328,203265,1460,201372,1787,1893,870,564310,2353,542831,3524,21479,2563,173471,1045,172943,1087,528,315
"Essex County, New York",35047,1207,6002,205,5887,244,115,133,20168,1130,18393,1256,1775,595,8877,242,8877,242,0,217
"Franklin County, New York",45052,630,10056,669,9919,693,137,199,26669,745,25081,916,1588,849,8327,307,8327,307,0,217
"Fulton County, New York",52214,459,11120,512,10966,555,154,219,30433,648,28283,1107,2150,944,10661,218,10661,218,0,217
"Genesee County, New York",57273,293,12076,680,11976,696,100,139,34049,741,31816,725,2233,931,11148,354,11009,375,139,138
"Greene County, New York",45151,1070,9007,905,8644,923,363,290,25217,1244,23644,1359,1573,840,10927,424,10927,424,0,217
"Herkimer County, New York",59359,325,12466,594,11726,575,740,694,34447,751,31291,1280,3156,1093,12446,444,12396,430,50,107
"Jefferson County, New York",103103,1590,28132,467,26266,1240,1866,1199,58505,1541,53517,2247,4988,1523,16466,474,16424,475,42,69
"Kings County, New York",2623994,2551,627433,2290,613614,3367,13819,2695,1606185,2840,1465121,8770,141064,8353,390376,1708,383900,2464,6476,1589
"Lewis County, New York",26256,359,6306,409,6195,447,111,132,14754,517,13399,781,1355,588,5196,162,5196,162,0,217
"Livingston County, New York",59781,583,13487,1022,13131,972,356,317,34982,1073,33433,1294,1549,540,11312,481,11312,481,0,217
"Madison County, New York",66818,442,14429,560,13943,636,486,350,39294,642,37885,755,1409,431,13095,240,13089,239,6,17
"Monroe County, New York",747875,1403,166229,1038,163795,1597,2434,1234,448175,1457,426794,3528,21381,3084,133471,877,133117,931,354,293
"Montgomery County, New York",48868,340,12945,599,12067,829,878,754,27177,709,25206,1095,1971,786,8746,387,8746,387,0,217
"Nassau County, New York",1381243,1824,315465,1399,309290,2291,6175,1815,815971,2099,774170,6108,41801,5495,249807,1078,247981,1605,1826,1344
"New York County, New York",1568178,2207,247219,2378,242145,3206,5074,1964,1037650,2860,971451,6899,66199,6688,283309,1481,280664,2032,2645,1187
"Niagara County, New York",209558,536,45005,779,44028,1086,977,793,121867,1117,117398,1477,4469,1025,42686,726,42663,724,23,38
"Oneida County, New York",224112,1294,51223,641,50589,814,634,481,129820,1312,122632,2083,7188,1888,43069,785,43069,785,0,217
"Onondaga County, New York",468175,1779,107870,1559,105596,1824,2274,1069,277441,1950,264485,2457,12956,1878,82864,899,82732,932,132,162
"Ontario County, New York",111587,471,22381,302,21801,480,580,382,64888,667,61935,1213,2953,970,24318,587,24291,596,27,44
"Orange County, New York",394959,2382,109123,1170,106617,1749,2506,1176,228857,2466,215150,3911,13707,2892,56979,639,56854,663,125,157
"Orleans County, New York",38340,504,7571,777,7419,809,152,235,23108,834,20668,1252,2440,967,7661,468,7646,466,15,26
"Oswego County, New York",116341,663,26798,830,25682,1133,1116,769,69799,1115,66090,1188,3709,1006,19744,422,19744,422,0,217
"Otsego County, New York",57502,429,11837,859,11376,964,461,423,33052,858,30642,1218,2410,873,12613,397,12597,399,16,29
"Putnam County, New York",97619,261,19983,545,19758,585,225,281,59188,726,54995,1418,4193,1283,18448,616,18400,620,48,84
"Queens County, New York",2316760,1897,487131,1938,472545,3936,14586,3527,1434881,2373,1257999,10401,176882,9840,394748,1520,386632,1960,8116,1503
"Rensselaer County, New York",158592,867,33496,636,33343,641,153,150,96894,1044,91456,1773,5438,1582,28202,667,28141,674,61,100
"Richmond County, New York",489777,1044,111117,1008,108966,1675,2151,1379,297059,1264,279178,3717,17881,3360,81601,668,81040,849,561,445
"Rockland County, New York",337659,434,104857,1229,104101,1256,756,458,180565,1175,170302,2202,10263,2085,52237,220,51560,611,677,591
"St. Lawrence County, New York",104503,994,24099,727,22428,1156,1671,1054,61171,1266,56932,1505,4239,1102,19233,399,19233,399,0,217
"Saratoga County, New York",235713,648,48365,560,47286,795,1079,566,142268,662,134907,1935,7361,1782,45080,556,45080,556,0,217
"Schenectady County, New York",156445,674,36140,621,35367,1043,773,870,93702,1227,88687,2130,5015,1629,26603,963,26603,963,0,217
"Schoharie County, New York",29824,72,5567,281,5351,405,216,312,17199,280,16479,435,720,321,7058,134,7058,134,0,217
"Seneca County, New York",31600,757,6923,428,5634,888,1289,735,18056,697,15719,688,2337,782,6621,467,6621,467,0,217
"Steuben County, New York",91787,574,21069,313,19743,1008,1326,909,52324,712,48952,1341,3372,1101,18394,393,18394,393,0,217
"Suffolk County, New York",1514297,2401,337808,2111,325440,4591,12368,4152,913407,2940,853099,5902,60308,5357,263082,1079,261347,1249,1735,749
"Sullivan County, New York",76328,1478,17413,1041,17348,1056,65,117,44483,1830,41899,2133,2584,1288,14432,685,14432,685,0,217
"Tioga County, New York",47538,451,9949,432,9858,450,91,149,27690,521,26671,761,1019,505,9899,186,9899,186,0,217
"Tompkins County, New York",104431,448,20287,1265,19309,1209,978,426,68294,1295,64712,1878,3582,1071,15850,478,15850,478,0,217
"Ulster County, New York",178368,1304,33404,782,32623,776,781,505,108133,1543,99371,2655,8762,2020,36831,775,36575,818,256,347
"Warren County, New York",65224,184,11983,653,11937,636,46,81,37769,734,36046,894,1723,565,15472,439,15472,439,0,217
"Washington County, New York",57498,1193,11524,204,11015,475,509,439,33882,1170,30776,1443,3106,1038,12092,177,12092,177,0,217
"Wayne County, New York",90200,420,19771,406,18755,767,1016,707,52441,473,47700,1547,4741,1423,17988,484,17988,484,0,217
"Westchester County, New York",985227,2366,227486,2345,220499,2767,6987,2432,584976,2862,540009,6041,44967,5399,172765,978,171612,1128,1153,627
"Wyoming County, New York",35828,4503,7475,490,7410,509,65,96,20749,3622,19825,3332,924,806,7604,550,7604,550,0,217
"Yates County, New York",24123,338,5388,263,2580,769,2808,775,13419,385,10263,1138,3156,1154,5316,390,5082,417,234,225
"Alamance County, North Carolina",173275,336,41487,941,39344,1102,2143,1248,102612,1097,86681,2442,15931,2119,29176,562,29050,576,126,163
"Alexander County, North Carolina",35410,1122,7644,1016,7644,1016,0,224,19663,1112,16015,1804,3648,1730,8103,1209,8103,1209,0,224
"Anson County, North Carolina",20859,1057,5005,1343,4095,1291,910,947,11861,1313,9339,1095,2522,978,3993,791,3993,791,0,224
"Ashe County, North Carolina",26511,276,5410,917,5073,752,337,404,13864,798,11872,1656,1992,1176,7237,338,7237,338,0,224
"Beaufort County, North Carolina",44117,324,9627,874,9338,967,289,278,23669,895,18987,1302,4682,1403,10821,200,10821,200,0,224
"Bladen County, North Carolina",29280,212,6927,830,6793,823,134,122,15653,855,14082,1205,1571,816,6700,158,6700,158,0,224
"Brunswick County, North Carolina",143337,648,20464,295,19694,824,770,728,74482,761,63022,2270,11460,2203,48391,549,48376,548,15,30
"Buncombe County, North Carolina",267492,1187,52142,769,50328,1143,1814,966,159014,1678,137252,3489,21762,3201,56336,1282,56136,1301,200,208
"Burke County, North Carolina",85296,1092,16926,913,16687,1017,239,278,50148,1296,41826,2088,8322,1901,18222,627,18222,627,0,224
"Cabarrus County, North Carolina",229580,619,63387,1811,62423,1952,964,570,135168,2039,115783,3514,19385,3918,31025,673,31025,673,0,224
"Caldwell County, North Carolina",79596,551,17096,727,16875,754,221,215,46171,1026,39061,2062,7110,2044,16329,601,16329,601,0,224
"Carteret County, North Carolina",67083,586,12203,690,11023,813,1180,672,36821,855,30140,1596,6681,1495,18059,543,18059,543,0,224
"Caswell County, North Carolina",21826,988,5294,1234,5286,1235,8,15,11893,1236,9595,1382,2298,937,4639,1143,4623,1138,16,25
"Catawba County, North Carolina",160013,783,36608,506,34899,1086,1709,1082,93604,1107,78405,2822,15199,2759,29801,850,29741,864,60,96
"Chatham County, North Carolina",77222,383,16308,817,15321,1068,987,618,41550,950,36234,1392,5316,1162,19364,807,19135,779,229,259
"Cherokee County, North Carolina",27362,2543,5200,1652,4788,1707,412,430,14492,1484,10172,1555,4320,1421,7670,1326,7670,1326,0,224
"Cleveland County, North Carolina",99593,934,23661,1197,22464,1478,1197,972,57403,834,45536,2609,11867,2548,18529,459,18529,459,0,224
"Columbus County, North Carolina",47682,893,11317,558,10238,1135,1079,970,26606,1041,21083,1641,5523,1587,9759,217,9486,503,273,409
"Craven County, North Carolina",92598,1991,22016,640,20325,1184,1691,1103,50956,1854,45985,2270,4971,1417,19626,711,19541,721,85,131
"Cumberland County, North Carolina",300224,2074,88660,841,83759,1451,4901,1445,169692,2267,144245,3129,25447,2586,41872,518,41588,552,284,197
"Currituck County, North Carolina",29316,307,6142,989,5564,1037,578,384,18068,979,15290,1409,2778,1368,5106,953,5106,953,0,224
"Dare County, North Carolina",37678,176,6675,970,6343,800,332,410,22364,1016,18843,1889,3521,1793,8639,285,8639,285,0,224
"Davidson County, North Carolina",169162,568,38844,646,37274,1025,1570,832,98932,1114,83228,3107,15704,2956,31386,752,31271,759,115,195
"Davie County, North Carolina",43340,206,9395,317,8683,677,712,579,24366,474,20814,1222,3552,1229,9579,286,9579,286,0,224
"Duplin County, North Carolina",48282,139,12022,356,10562,834,1460,792,26799,491,19817,1764,6982,1749,9461,478,9134,135,327,468
"Durham County, North Carolina",321139,1623,70178,1518,65074,2539,5104,1989,205249,2268,174946,4647,30303,4037,45712,1068,44319,1079,1393,1012
"Edgecombe County, North Carolina",47635,567,10846,739,10307,821,539,458,26857,879,22284,1601,4573,1387,9932,335,9932,335,0,224
"Forsyth County, North Carolina",382638,1055,93568,1177,88980,1666,4588,1648,225599,1670,189720,4341,35879,3842,63471,697,63031,690,440,423
"Franklin County, North Carolina",71035,536,16929,757,16457,854,472,337,42112,882,36433,1434,5679,1253,11994,300,11913,340,81,137
"Gaston County, North Carolina",229123,848,54126,650,51652,1668,2474,1392,137906,1140,117756,3213,20150,3209,37091,559,36900,602,191,225
"Granville County, North Carolina",59275,1769,13074,538,12694,706,380,448,35371,1677,30999,2068,4372,1502,10830,411,10830,411,0,224
"Greene County, North Carolina",18235,1958,4920,1291,4239,1311,681,586,9879,1418,6814,1137,3065,1048,3436,712,3293,718,143,174
"Guilford County, North Carolina",538728,1708,132344,1790,126494,2193,5850,1735,321789,2500,279341,5419,42448,4746,84595,755,83997,800,598,360
"Halifax County, North Carolina",47515,525,10898,454,10587,688,311,503,26056,742,22731,1185,3325,939,10561,328,10561,328,0,224
"Harnett County, North Carolina",128499,1387,37488,929,35916,1218,1572,748,73454,1684,61813,2175,11641,1677,17557,914,17497,932,60,79
"Haywood County, North Carolina",62184,218,10985,350,9890,880,1095,819,35789,371,28642,1308,7147,1279,15410,226,15350,223,60,98
"Henderson County, North Carolina",116061,311,24051,1171,23424,1181,627,506,62155,1282,49705,2636,12450,2413,29855,585,29855,585,0,224
"Hertford County, North Carolina",20346,520,4357,290,3988,400,369,206,11606,509,10405,821,1201,508,4383,255,4383,255,0,224
"Hoke County, North Carolina",49377,1505,15577,760,15327,690,250,310,28234,1659,23831,1784,4403,1330,5566,325,5566,325,0,224
"Iredell County, North Carolina",190607,872,45436,790,43440,1238,1996,1036,114139,1038,98279,2604,15860,2751,31032,476,31032,476,0,224
"Jackson County, North Carolina",43145,200,7561,311,6857,634,704,546,26336,462,21389,1133,4947,1075,9248,359,9248,359,0,224
"Johnston County, North Carolina",224995,673,60101,1194,56012,2174,4089,1760,134156,1735,115262,3593,18894,3080,30738,977,30376,985,362,254
"Lee County, North Carolina",63206,404,16696,677,16051,703,645,462,35956,1076,28235,2037,7721,1632,10554,625,10359,530,195,316
"Lenoir County, North Carolina",53905,780,12390,1506,11829,1320,561,835,30193,1545,24654,1662,5539,1431,11322,180,11322,180,0,224
"Lincoln County, North Carolina",89278,263,19447,399,18120,928,1327,828,52360,875,44878,1847,7482,1692,17471,686,17339,732,132,219
"McDowell County, North Carolina",43724,697,9109,509,8657,685,452,407,25204,680,19210,1776,5994,1695,9411,400,9250,444,161,188
"Macon County, North Carolina",37445,118,6755,919,5988,1030,767,527,19599,859,15194,1363,4405,1241,11091,384,10831,490,260,325
"Madison County, North Carolina",21204,274,4073,915,4073,915,0,224,11973,906,10694,1104,1279,843,5158,1090,5158,1090,0,224
"Martin County, North Carolina",20632,2373,4879,1459,4869,1456,10,19,11014,1476,9277,1490,1737,706,4739,1111,4739,1111,0,224
"Mecklenburg County, North Carolina",1115534,1363,272362,1800,249676,3773,22686,3609,711696,2203,604524,6569,107172,6109,131476,412,129969,963,1507,810
"Montgomery County, North Carolina",25034,776,5886,380,5264,564,622,440,14161,792,11476,1088,2685,915,4987,455,4987,455,0,224
"Moore County, North Carolina",98018,1212,22949,770,21435,1424,1514,1159,50860,1548,43657,1948,7203,1718,24209,799,24192,798,17,30
"Nash County, North Carolina",94353,396,21719,506,20767,1100,952,926,54806,708,44402,2196,10404,2269,17828,393,17762,419,66,112
"New Hanover County, North Carolina",226810,1188,43615,752,41788,1417,1827,1267,140951,1313,122506,3256,18445,2972,42244,615,42068,673,176,231
"Onslow County, North Carolina",165557,3790,50961,635,47673,2137,3288,2109,94994,3633,78061,4406,16933,3883,19602,480,19602,480,0,224
"Orange County, North Carolina",148362,255,30603,1258,29768,1265,835,696,94597,1359,85869,2172,8728,2213,23162,699,22633,693,529,458
"Pasquotank County, North Carolina",39561,683,10030,918,9593,1076,437,459,22185,759,18853,1283,3332,1152,7346,503,7346,503,0,224
"Pender County, North Carolina",61190,638,14741,633,12196,1170,2545,1501,35065,779,29837,1616,5228,1306,11384,296,11317,323,67,102
"Person County, North Carolina",38831,239,8600,540,8468,621,132,257,21976,930,18320,1623,3656,1427,8255,728,8159,744,96,162
"Pitt County, North Carolina",171143,776,40980,1552,38379,2032,2601,1280,105791,1806,90594,3281,15197,2887,24372,339,24238,373,134,154
"Polk County, North Carolina",19408,152,2144,645,2144,645,0,224,10635,874,9228,1120,1407,821,6629,1155,6629,1155,0,224
"Randolph County, North Carolina",144369,458,34214,1044,33077,1363,1137,918,84636,1211,68123,2720,16513,2407,25519,514,25452,476,67,111
"Richmond County, North Carolina",41648,649,10416,680,9773,443,643,673,23283,1129,19518,1890,3765,1114,7949,579,7949,579,0,224
"Robeson County, North Carolina",114523,662,31675,630,29963,836,1712,663,64803,847,50460,1860,14343,1627,18045,302,17862,352,183,165
"Rockingham County, North Carolina",90338,407,19236,558,18516,967,720,685,52368,645,42965,2015,9403,1975,18734,305,18734,305,0,224
"Rowan County, North Carolina",145747,1316,33805,732,31694,1448,2111,1457,86566,1335,70439,2290,16127,1988,25376,401,25376,401,0,224
"Rutherford County, North Carolina",63801,374,13920,597,13334,926,586,650,35985,740,29309,1920,6676,1883,13896,554,13776,577,120,204
"Sampson County, North Carolina",57973,990,15072,412,14578,516,494,309,32175,1052,25408,1506,6767,1345,10726,503,10390,340,336,333
"Scotland County, North Carolina",32320,3066,8577,418,8395,451,182,200,17887,2634,13960,1952,3927,1223,5856,495,5856,495,0,224
"Stanly County, North Carolina",61981,809,14295,441,13238,759,1057,613,35868,936,30096,1345,5772,1251,11818,632,11818,632,0,224
"Stokes County, North Carolina",44135,240,8408,736,8293,732,115,202,25798,802,23130,1526,2668,1536,9929,381,9929,381,0,224
"Surry County, North Carolina",70491,275,15608,366,14630,726,978,744,40506,671,33079,1686,7427,1460,14377,445,14216,480,161,256
"Transylvania County, North Carolina",32882,225,7491,912,7354,951,137,180,16124,1317,13127,1347,2997,1072,9267,1179,9228,1177,39,69
"Union County, North Carolina",242628,588,67736,978,63274,1984,4462,1760,143302,1366,127396,2966,15906,2728,31590,584,31519,586,71,78
"Vance County, North Carolina",41845,309,10197,231,9902,442,295,342,23046,681,17731,1580,5315,1521,8602,640,8602,640,0,224
"Wake County, North Carolina",1143433,1813,284735,1906,269079,4241,15656,3637,716087,2627,639503,7623,76584,6703,142611,436,140678,1014,1933,885
"Watauga County, North Carolina",53996,175,9297,1178,8947,1162,350,358,35430,1202,32291,1608,3139,1098,9269,183,9269,183,0,224
"Wayne County, North Carolina",111835,1631,29800,812,28373,1218,1427,889,62568,1947,50010,2985,12558,2233,19467,579,19467,579,0,224
"Wilkes County, North Carolina",64962,463,14593,818,14334,812,259,274,35776,1001,27348,2206,8428,1892,14593,509,14120,468,473,367
"Wilson County, North Carolina",77395,573,18979,645,17009,1064,1970,1031,44014,875,33409,2100,10605,2294,14402,411,14305,407,97,127
"Yadkin County, North Carolina",36612,475,8502,458,7821,627,681,495,20432,719,16540,1107,3892,936,7678,454,7522,296,156,195
"Burleigh County, North Dakota",97088,628,23942,796,22790,1006,1152,676,57084,931,53241,1472,3843,1199,16062,374,16062,374,0,170
"Cass County, North Dakota",184611,1301,45411,906,42437,1660,2974,1342,115851,1741,108159,2475,7692,2075,23349,486,23349,486,0,170
"Grand Forks County, North Dakota",69661,1084,17663,730,17315,764,348,299,42920,1243,38537,1304,4383,1301,9078,358,9078,358,0,170
"Morton County, North Dakota",33089,279,7121,668,7089,676,32,45,20141,814,17105,948,3036,1129,5827,546,5827,546,0,170
"Stark County, North Dakota",32816,206,9542,760,9434,781,108,183,18998,767,16984,959,2014,822,4276,188,4276,188,0,170
"Stutsman County, North Dakota",20543,460,4051,240,3284,597,767,578,12356,612,11344,721,1012,583,4136,422,4136,422,0,170
"Ward County, North Dakota",63048,1568,17664,881,17104,871,560,560,36600,1605,31620,1923,4980,1454,8784,357,8539,530,245,380
"Williams County, North Dakota",38200,345,12486,1178,10298,1529,2188,1113,22352,1174,19472,1828,2880,1377,3362,160,3306,179,56,99
"Adams County, Ohio",27317,164,7092,443,7092,443,0,204,15153,432,13678,759,1475,683,5072,326,4874,416,198,283
"Allen County, Ohio",98651,801,24668,570,23522,903,1146,698,55707,956,50126,1481,5581,1221,18276,510,18252,515,24,43
"Ashland County, Ohio",51776,341,12717,401,10952,1404,1765,1424,29147,433,25662,1335,3485,1290,9912,447,9859,487,53,89
"Ashtabula County, Ohio",94383,557,22630,340,18648,2427,3982,2368,52863,954,45312,1741,7551,1845,18890,659,18719,681,171,140
"Athens County, Ohio",60986,859,12893,1345,12893,1345,0,204,39026,1514,35282,1959,3744,1183,9067,412,8920,467,147,231
"Auglaize County, Ohio",45678,189,11172,489,10559,773,613,586,25990,505,24011,818,1979,706,8516,180,8516,180,0,204
"Belmont County, Ohio",62369,903,12822,361,11907,864,915,812,35883,747,32542,1228,3341,1140,13664,336,13664,336,0,204
"Brown County, Ohio",43181,301,11066,530,10196,1074,870,922,24321,538,20097,1516,4224,1388,7794,315,7794,315,0,204
"Butler County, Ohio",386573,1010,97521,1239,89795,2858,7726,2635,230489,1711,209533,3800,20956,3584,58563,943,57745,972,818,516
"Carroll County, Ohio",26460,148,5542,205,4906,678,636,625,15209,265,14355,564,854,513,5709,220,5709,220,0,204
"Champaign County, Ohio",38317,328,9288,401,8879,479,409,379,22151,456,20153,1053,1998,800,6878,212,6878,212,0,204
"Clark County, Ohio",134106,587,32203,390,31765,444,438,264,76240,584,69002,1731,7238,1587,25663,418,25621,413,42,78
"Clermont County, Ohio",208478,615,49215,819,47397,1008,1818,934,123084,1039,111996,2989,11088,2832,36179,391,36109,406,70,105
"Clinton County, Ohio",41736,162,9940,380,9673,420,267,259,24256,408,21570,896,2686,832,7540,349,7530,350,10,20
"Columbiana County, Ohio",98978,677,21880,511,20462,1107,1418,1072,56263,867,49878,1780,6385,1482,20835,327,20821,332,14,24
"Coshocton County, Ohio",36321,175,9305,256,6526,1037,2779,1003,19805,375,16738,1043,3067,1020,7211,295,7062,323,149,153
"Crawford County, Ohio",41321,235,9943,356,9208,707,735,563,23031,379,20515,1059,2516,985,8347,184,8347,184,0,204
"Cuyahoga County, Ohio",1234798,2784,269108,1412,261915,2307,7193,1889,735426,2955,679524,5807,55902,5001,230264,1031,228726,1209,1538,578
"Darke County, Ohio",51153,215,12795,307,11657,714,1138,657,28335,361,25415,902,2920,827,10023,270,9979,282,44,75
"Defiance County, Ohio",37866,187,9375,509,9194,550,181,236,21078,620,19011,1009,2067,835,7413,306,7413,306,0,204
"Delaware County, Ohio",220064,268,58839,824,56850,1326,1989,996,128800,1017,121728,2265,7072,2154,32425,638,32425,638,0,204
"Erie County, Ohio",73736,724,15761,435,15376,529,385,354,40891,709,35007,1920,5884,1742,17084,766,17084,766,0,204
"Fairfield County, Ohio",158211,1106,40785,686,38999,993,1786,905,92824,1323,82211,2678,10613,2363,24602,693,24522,673,80,137
"Fayette County, Ohio",28661,225,7172,283,6975,413,197,277,16365,313,15134,660,1231,590,5124,188,5124,188,0,204
"Franklin County, Ohio",1314080,1228,323864,1704,309285,3308,14579,2956,825772,2007,734283,6993,91489,6904,164444,677,162456,1143,1988,944
"Fulton County, Ohio",42078,233,10373,254,9663,715,710,654,24112,349,22618,727,1494,646,7593,231,7593,231,0,204
"Gallia County, Ohio",28818,197,7463,538,6488,1050,975,1033,15657,644,14119,1029,1538,749,5698,316,5698,316,0,204
"Geauga County, Ohio",94852,308,22706,480,18977,1413,3729,1422,51965,624,46034,1324,5931,1321,20181,377,20021,395,160,122
"Greene County, Ohio",164005,1243,37940,909,36547,1200,1393,821,95648,1683,87991,2085,7657,1503,30417,709,30180,755,237,246
"Guernsey County, Ohio",37944,245,8727,579,7657,1168,1070,1098,21651,517,18909,1072,2742,971,7566,294,7536,299,30,53
"Hamilton County, Ohio",815618,2140,200808,1462,191522,2974,9286,2554,488549,2758,452678,4832,35871,4266,126261,1143,125749,1243,512,344
"Hancock County, Ohio",74057,356,16840,440,16193,624,647,537,43520,644,39930,1313,3590,1111,13697,480,13697,480,0,204
"Hardin County, Ohio",30431,222,7715,328,5007,1701,2708,1697,17740,356,14964,1081,2776,1011,4976,169,4885,214,91,134
"Henry County, Ohio",27146,190,7000,472,6804,485,196,171,14983,506,14382,550,601,292,5163,195,5114,204,49,82
"Highland County, Ohio",42946,209,10792,301,10215,743,577,709,24160,525,21243,1032,2917,896,7994,410,7955,422,39,65
"Hocking County, Ohio",27956,327,6307,235,5937,466,370,477,16289,268,14061,890,2228,809,5360,340,5360,340,0,204
"Holmes County, Ohio",43547,302,13910,235,6304,1466,7606,1430,23878,341,14091,1629,9787,1683,5759,307,5579,395,180,261
"Huron County, Ohio",57961,181,14675,409,14037,566,638,512,32887,469,29681,1147,3206,1098,10399,342,10399,342,0,204
"Jackson County, Ohio",32215,179,8110,392,7724,316,386,417,18696,391,17154,894,1542,849,5409,188,5409,188,0,204
"Jefferson County, Ohio",64088,377,12993,427,12400,707,593,530,37083,615,33912,1074,3171,870,14012,282,13915,289,97,101
"Knox County, Ohio",62218,328,15005,810,14330,995,675,620,35283,922,31251,1445,4032,1300,11930,515,11785,480,145,177
"Lake County, Ohio",230455,529,47715,779,46173,968,1542,780,134716,1088,127004,2117,7712,1557,48024,664,47798,658,226,189
"Lawrence County, Ohio",56610,434,12811,336,12187,733,624,558,33003,693,28977,1290,4026,1384,10796,338,10796,338,0,204
"Licking County, Ohio",179051,574,43690,1200,41765,1840,1925,1412,104940,1554,96539,2124,8401,2378,30421,556,30255,601,166,258
"Logan County, Ohio",45766,249,11427,617,11258,653,169,151,25593,617,23852,896,1741,630,8746,307,8746,307,0,204
"Lorain County, Ohio",310261,865,73266,1075,70580,2056,2686,1565,178119,1462,165527,2268,12592,2080,58876,527,58696,604,180,303
"Lucas County, Ohio",424378,1344,103855,1066,100924,1741,2931,1230,249424,1405,230318,3244,19106,3147,71099,657,70849,706,250,283
"Madison County, Ohio",39880,773,9398,208,9350,228,48,84,23661,771,21153,1038,2508,826,6821,174,6821,174,0,204
"Mahoning County, Ohio",222657,1108,48204,625,47954,703,250,229,126904,1282,117553,1866,9351,1609,47549,496,47386,502,163,179
"Marion County, Ohio",59753,885,14423,398,14346,421,77,135,33400,857,30561,1102,2839,926,11930,487,11875,476,55,95
"Medina County, Ohio",181808,416,42021,526,40844,1180,1177,1133,105798,851,101902,1658,3896,1240,33989,537,33961,543,28,46
"Meigs County, Ohio",21871,203,5282,519,4621,700,661,507,11838,567,9729,988,2109,979,4751,327,4751,327,0,204
"Mercer County, Ohio",41734,292,11843,386,11595,475,248,278,22260,371,20242,876,2018,880,7631,285,7631,285,0,204
"Miami County, Ohio",108350,395,26242,467,25183,819,1059,656,61063,866,56459,1447,4604,1171,21045,731,21045,731,0,204
"Montgomery County, Ohio",527361,1571,127471,1808,122056,2378,5415,1454,304771,2301,278310,3758,26461,3255,95119,812,95013,830,106,125
"Morrow County, Ohio",34829,327,8240,644,7717,958,523,519,20318,663,18212,1108,2106,986,6271,173,6271,173,0,204
"Muskingum County, Ohio",85598,542,20352,698,19323,851,1029,852,50224,805,44487,1545,5737,1425,15022,358,15022,358,0,204
"Ottawa County, Ohio",39685,205,7634,473,7620,466,14,29,21860,543,20812,804,1048,572,10191,299,10191,299,0,204
"Perry County, Ohio",35185,198,8708,291,8681,293,27,31,20461,364,17672,1314,2789,1211,6016,209,5953,190,63,107
"Pickaway County, Ohio",55406,938,13060,480,11705,876,1355,754,33311,819,29715,1645,3596,1544,9035,281,9035,281,0,204
"Pike County, Ohio",26919,236,6808,271,6808,271,0,204,15199,407,14008,749,1191,623,4912,135,4912,135,0,204
"Portage County, Ohio",161456,416,35388,1286,33196,2750,2192,2204,97348,1486,89449,2610,7899,2493,28720,855,28720,855,0,204
"Preble County, Ohio",40633,157,9674,342,9487,410,187,161,22916,310,21444,616,1472,542,8043,183,8043,183,0,204
"Putnam County, Ohio",34068,158,9198,261,9181,267,17,30,18781,344,18052,467,729,318,6089,284,6058,259,31,53
"Richland County, Ohio",118553,1330,28489,681,25777,2243,2712,2067,65955,1337,57657,2323,8298,2187,24109,556,23905,617,204,254
"Ross County, Ohio",71426,837,16699,396,16279,738,420,593,41843,955,39249,1187,2594,961,12884,490,12884,490,0,204
"Sandusky County, Ohio",57847,333,13495,354,12693,807,802,717,33136,678,30637,1169,2499,975,11216,566,11178,561,38,65
"Scioto County, Ohio",70534,1006,17065,743,16773,764,292,333,40384,1322,36769,1858,3615,1253,13085,412,13085,412,0,204
"Seneca County, Ohio",54185,389,12934,362,12741,399,193,169,31127,554,28744,921,2383,763,10124,356,10124,356,0,204
"Shelby County, Ohio",47636,296,12580,330,12474,410,106,166,26959,535,25698,823,1261,702,8097,431,8081,433,16,28
"Stark County, Ohio",368911,1388,85521,1008,82598,1385,2923,921,210151,1671,190701,2663,19450,2739,73239,610,72902,632,337,268
"Summit County, Ohio",532588,1329,118068,1048,114694,1666,3374,1176,314757,1658,289147,3112,25610,3076,99763,574,99516,607,247,241
"Trumbull County, Ohio",197989,855,43894,906,40652,2000,3242,1817,110643,1158,100370,2269,10273,1860,43452,502,43320,531,132,161
"Tuscarawas County, Ohio",91667,264,22173,900,20565,1304,1608,996,51810,915,45481,1627,6329,1511,17684,376,17684,376,0,204
"Union County, Ohio",61469,1632,16761,770,15236,1039,1525,1023,36733,1622,33203,2268,3530,1812,7975,319,7759,400,216,298
"Van Wert County, Ohio",28441,265,6917,362,6853,376,64,107,16065,430,14946,707,1119,670,5459,356,5459,356,0,204
"Warren County, Ohio",237650,1856,62076,830,60951,1138,1125,869,138761,2079,131545,2794,7216,2062,36813,571,36665,645,148,188
"Washington County, Ohio",58943,321,12602,272,11016,1050,1586,1052,33944,394,30789,1046,3155,1055,12397,222,12397,222,0,204
"Wayne County, Ohio",115652,352,29225,716,20599,2538,8626,2424,65219,693,54843,1481,10376,1553,21208,434,21095,422,113,146
"Williams County, Ohio",35766,606,8344,289,8139,358,205,245,20269,566,19075,710,1194,504,7153,382,7153,382,0,204
"Wood County, Ohio",131404,388,29662,901,29197,1099,465,501,81000,979,76038,1353,4962,1158,20742,370,20742,370,0,204
"Wyandot County, Ohio",21465,328,5191,399,5094,415,97,122,12109,412,11429,548,680,338,4165,282,4165,282,0,204
"Adair County, Oklahoma",19289,186,5586,141,5036,341,550,335,10706,241,7551,526,3155,523,2997,156,2805,156,192,182
"Beckham County, Oklahoma",18796,2318,4806,1092,4754,1082,52,96,10985,1570,8050,1664,2935,1218,3005,542,3005,542,0,172
"Bryan County, Oklahoma",46594,298,11695,261,9797,581,1898,584,26709,406,18681,1110,8028,1062,8190,258,8115,249,75,74
"Caddo County, Oklahoma",25406,467,6897,285,6242,393,655,342,14094,430,9034,798,5060,810,4415,153,4341,195,74,117
"Canadian County, Oklahoma",158827,1310,43974,995,41319,1360,2655,917,92279,1689,80243,2558,12036,2133,22574,591,22516,584,58,79
"Carter County, Oklahoma",47736,475,12607,248,11801,435,806,334,27137,516,22211,1000,4926,882,7992,366,7964,369,28,46
"Cherokee County, Oklahoma",47328,219,11058,478,9417,714,1641,593,28393,492,20497,1543,7896,1548,7877,170,7666,292,211,253
"Cleveland County, Oklahoma",290763,1470,67432,1435,64669,1693,2763,1164,181243,2128,157547,3804,23696,3195,42088,583,42017,583,71,69
"Comanche County, Oklahoma",108707,1498,30476,998,28006,1501,2470,1314,62542,1640,49181,2320,13361,2157,15689,419,15508,431,181,169
"Creek County, Oklahoma",71313,378,17570,286,16363,735,1207,696,40784,497,32569,1169,8215,1110,12959,231,12911,235,48,56
"Custer County, Oklahoma",27652,394,7348,419,7298,421,50,72,16488,751,14957,883,1531,751,3816,436,3816,436,0,172
"Delaware County, Oklahoma",40668,197,8777,332,8027,479,750,291,21759,365,16673,1054,5086,1092,10132,199,10086,202,46,45
"Garfield County, Oklahoma",59702,706,16784,529,16206,664,578,459,32307,1065,25242,1788,7065,1761,10611,645,10533,661,78,134
"Garvin County, Oklahoma",25678,113,6961,239,5905,599,1056,571,14177,242,11320,635,2857,580,4540,160,4540,160,0,172
"Grady County, Oklahoma",54808,357,13614,190,12941,412,673,394,31837,451,25402,1302,6435,1171,9357,247,9357,247,0,172
"Jackson County, Oklahoma",23061,738,6016,234,5835,273,181,180,13491,788,10310,1120,3181,1039,3554,314,3554,314,0,172
"Kay County, Oklahoma",43035,549,11427,480,11006,560,421,318,23289,625,19015,962,4274,840,8319,223,8301,222,18,31
"Le Flore County, Oklahoma",47202,547,12549,352,11254,491,1295,483,26355,537,19324,1016,7031,966,8298,294,8276,288,22,37
"Lincoln County, Oklahoma",33436,193,8367,313,7621,551,746,383,18715,343,14161,794,4554,818,6354,288,6354,288,0,172
"Logan County, Oklahoma",50429,332,12004,442,11470,663,534,614,30402,590,25002,1722,5400,1585,8023,332,8023,332,0,172
"McClain County, Oklahoma",43351,127,12109,588,11654,632,455,318,24388,612,21233,965,3155,907,6854,289,6824,293,30,52
"McCurtain County, Oklahoma",30634,189,8260,293,7469,441,791,341,16970,352,12989,725,3981,648,5404,222,5388,232,16,26
"McIntosh County, Oklahoma",19033,184,4026,739,3152,806,874,464,10385,742,6932,908,3453,893,4622,699,4622,699,0,172
"Mayes County, Oklahoma",38885,235,9839,387,8857,512,982,398,21861,377,16712,878,5149,859,7185,177,7169,177,16,29
"Muskogee County, Oklahoma",63497,702,16966,396,15010,866,1956,801,35708,813,27705,1420,8003,1231,10823,282,10683,296,140,152
"Oklahoma County, Oklahoma",786282,1799,211250,1007,198267,2844,12983,2899,462903,1831,370819,5930,92084,5896,112129,490,110695,792,1434,654
"Okmulgee County, Oklahoma",36360,374,8700,440,8192,518,508,242,20886,531,15940,909,4946,913,6774,240,6682,261,92,97
"Osage County, Oklahoma",43870,554,10528,411,9893,576,635,430,24059,721,20749,956,3310,781,9283,355,9256,349,27,45
"Ottawa County, Oklahoma",29977,255,7986,152,7432,261,554,239,16647,300,12222,527,4425,474,5344,154,5203,215,141,155
"Payne County, Oklahoma",80841,674,18706,1160,17143,1172,1563,734,51239,1381,43074,2597,8165,2042,10896,421,10896,421,0,172
"Pittsburg County, Oklahoma",41985,526,10218,348,9201,486,1017,424,23335,559,17025,909,6310,820,8432,288,8397,290,35,38
"Pontotoc County, Oklahoma",37863,147,9931,294,8557,629,1374,584,21938,329,17025,966,4913,987,5994,225,5940,245,54,91
"Pottawatomie County, Oklahoma",70936,1025,17812,568,16060,944,1752,839,41172,1164,33086,1561,8086,1306,11952,261,11828,308,124,121
"Rogers County, Oklahoma",95759,595,23568,368,21463,678,2105,606,56242,542,45739,1306,10503,1304,15949,386,15811,391,138,124
"Seminole County, Oklahoma",23162,258,6335,202,5379,362,956,351,12639,296,9532,743,3107,630,4188,207,4148,203,40,47
"Sequoyah County, Oklahoma",39197,276,9713,243,9215,462,498,337,22272,362,16587,1027,5685,997,7212,249,7135,275,77,113
"Stephens County, Oklahoma",42739,320,10510,383,9838,556,672,409,23421,602,17781,1186,5640,1071,8808,351,8782,351,26,44
"Texas County, Oklahoma",19836,1755,5892,626,5892,626,0,172,11642,1364,9559,1428,2083,768,2302,492,2282,493,20,36
"Tulsa County, Oklahoma",667901,1131,177307,950,164222,1914,13085,1752,391502,1314,309663,4299,81839,4193,99092,505,98368,560,724,283
"Wagoner County, Oklahoma",83736,237,21016,284,19512,726,1504,645,48741,433,40928,1251,7813,1183,13979,256,13903,276,76,85
"Washington County, Oklahoma",52429,262,13069,517,12422,670,647,395,28922,726,23787,1204,5135,1084,10438,398,10438,398,0,172
"Woodward County, Oklahoma",20859,1363,5691,693,4594,1048,1097,776,11356,1003,8819,1231,2537,1245,3812,568,3812,568,0,172
"Benton County, Oregon",95832,147,18055,1304,17706,1247,349,308,60747,1377,56151,2036,4596,1397,17030,614,17030,614,0,214
"Clackamas County, Oregon",420799,691,93005,980,91193,1214,1812,855,248022,1162,232266,2765,15756,2380,79772,486,79125,672,647,471
"Clatsop County, Oregon",41129,448,7214,869,6766,1025,448,383,23685,1058,20151,1535,3534,1194,10230,270,10230,270,0,214
"Columbia County, Oregon",52853,373,11666,678,10658,769,1008,766,30470,927,27662,1529,2808,1203,10717,535,10717,535,0,214
"Coos County, Oregon",64395,282,12306,442,11774,562,532,558,34757,686,31174,1316,3583,1244,17332,657,17332,657,0,214
"Crook County, Oregon",25674,101,6555,1190,5855,1288,700,508,13483,1221,11434,1374,2049,1051,5636,1321,5636,1321,0,214
"Curry County, Oregon",21906,1901,2663,1033,2663,1033,0,214,10966,1669,10226,1709,740,620,8277,1669,8277,1669,0,214
"Deschutes County, Oregon",204317,389,40862,1087,37677,1982,3185,1684,121219,1285,108387,3098,12832,2934,42236,772,41802,996,434,600
"Douglas County, Oregon",111150,523,22530,599,21524,975,1006,764,59415,872,54447,1593,4968,1585,29205,487,28849,625,356,410
"Hood River County, Oregon",23922,176,4897,1285,4833,1288,64,116,13312,1345,11183,1752,2129,1171,5713,1347,5713,1347,0,214
"Jackson County, Oregon",222583,690,48090,928,45546,1739,2544,1314,123871,1115,112576,2124,11295,2128,50622,542,50598,540,24,42
"Jefferson County, Oregon",24169,773,6710,1277,5865,1317,845,588,12214,1118,10537,1409,1677,632,5245,1077,5044,1082,201,322
"Josephine County, Oregon",87703,449,18047,952,16837,1216,1210,927,45965,1056,40109,2418,5856,2055,23691,672,23691,672,0,214
"Klamath County, Oregon",68763,770,16341,609,15373,896,968,582,37484,950,32508,1542,4976,1237,14938,373,14859,383,79,139
"Lane County, Oregon",381666,765,74541,1161,72945,1351,1596,761,229240,1395,209301,3045,19939,2784,77885,446,77309,713,576,461
"Lincoln County, Oregon",50518,311,8422,316,8201,395,221,217,26798,444,22763,1003,4035,1046,15298,361,15192,370,106,120
"Linn County, Oregon",129111,418,30342,698,29284,1016,1058,811,74155,933,67355,1586,6800,1815,24614,653,24364,570,250,326
"Malheur County, Oregon",27931,904,8117,205,8055,232,62,120,15183,809,12723,985,2460,849,4631,401,4554,407,77,97
"Marion County, Oregon",340229,1793,87561,1040,85014,1458,2547,994,197168,1799,173199,3731,23969,3481,55500,676,55120,753,380,398
"Multnomah County, Oregon",798712,1616,153367,1176,148773,2150,4594,1891,532051,1908,490564,5215,41487,4815,113294,426,112432,884,862,749
"Polk County, Oregon",88827,338,22155,765,21830,764,325,416,50184,762,47740,1385,2444,1196,16488,401,16488,401,0,214
"Tillamook County, Oregon",27275,189,5366,358,5356,363,10,22,14381,450,13420,549,961,458,7528,301,7528,301,0,214
"Umatilla County, Oregon",75698,1352,21520,736,20398,948,1122,791,41003,1542,37423,2057,3580,1292,13175,601,12945,609,230,311
"Union County, Oregon",26046,149,6242,382,6054,409,188,231,14315,422,12856,897,1459,796,5489,235,5452,242,37,64
"Wasco County, Oregon",26449,245,6188,333,6155,333,33,56,15013,424,13644,865,1369,738,5248,352,5248,352,0,214
"Washington County, Oregon",597143,1205,138370,1134,134278,1938,4092,1579,373532,1661,348815,4183,24717,3614,85241,711,84844,796,397,421
"Yamhill County, Oregon",105764,820,25381,907,25054,968,327,262,60681,1284,56311,1630,4370,1218,19702,547,19501,624,201,274
"Adams County, Pennsylvania",103063,720,21662,568,20521,837,1141,668,59018,715,53564,1208,5454,1132,22383,616,22373,617,10,23
"Allegheny County, Pennsylvania",1226020,4792,249010,1606,244256,2266,4754,1628,739719,5021,699546,5798,40173,3650,237291,1071,236337,1228,954,794
"Armstrong County, Pennsylvania",64609,346,12698,281,12491,274,207,141,36967,359,35381,734,1586,592,14944,316,14944,316,0,189
"Beaver County, Pennsylvania",164996,934,34170,401,33596,737,574,601,94506,818,88431,1637,6075,1333,36320,445,36320,445,0,189
"Bedford County, Pennsylvania",47042,471,9729,132,8987,476,742,468,26306,438,23241,889,3065,800,11007,186,10990,186,17,28
"Berks County, Pennsylvania",425232,1892,101479,1108,96668,1696,4811,1427,249719,1878,228006,3456,21713,2755,74034,858,73257,898,777,392
"Blair County, Pennsylvania",119902,1134,27061,556,24871,1000,2190,829,67967,1107,62486,1659,5481,1367,24874,525,24791,532,83,92
"Bradford County, Pennsylvania",59229,586,13970,236,12868,657,1102,554,32233,487,29106,774,3127,679,13026,332,13026,332,0,189
"Bucks County, Pennsylvania",639930,1449,138125,1510,136623,1792,1502,702,377160,1716,358486,3344,18674,3085,124645,934,124291,972,354,268
"Butler County, Pennsylvania",192257,1186,40738,882,40165,845,573,373,113489,1227,107420,2062,6069,1764,38030,506,38028,506,2,4
"Cambria County, Pennsylvania",129101,1514,27103,481,26264,809,839,646,71727,1527,67684,1570,4043,1077,30271,582,30271,582,0,189
"Carbon County, Pennsylvania",64498,753,13945,543,13945,543,0,189,36939,742,34819,1122,2120,919,13614,496,13614,496,0,189
"Centre County, Pennsylvania",152091,1059,28915,1474,26333,2051,2582,1433,99424,1836,93899,2261,5525,1582,23752,673,23560,666,192,197
"Chester County, Pennsylvania",534283,1110,127532,1265,121633,3234,5899,2707,316710,1452,297499,2854,19211,2568,90041,688,89693,738,348,332
"Clarion County, Pennsylvania",36901,233,8125,302,7676,464,449,326,21173,334,19793,542,1380,469,7603,107,7603,107,0,189
"Clearfield County, Pennsylvania",74647,1270,15837,746,14936,1022,901,698,42077,837,38302,1383,3775,1069,16733,530,16702,530,31,32
"Clinton County, Pennsylvania",37031,344,7764,276,6200,1109,1564,1143,22199,366,19757,894,2442,811,7068,330,6867,481,201,291
"Columbia County, Pennsylvania",64286,339,13625,403,13413,432,212,196,37750,472,36232,777,1518,527,12911,338,12858,341,53,66
"Crawford County, Pennsylvania",81637,819,17378,320,15767,754,1611,663,46368,717,41987,1155,4381,956,17891,327,17731,385,160,157
"Cumberland County, Pennsylvania",256790,1441,59384,845,57198,1664,2186,1430,148888,1450,139537,2493,9351,2374,48518,777,48112,904,406,449
"Dauphin County, Pennsylvania",283327,1495,68384,1208,66513,1598,1871,1145,165378,1503,152676,2891,12702,2484,49565,1159,49281,1131,284,274
"Delaware County, Pennsylvania",567268,2850,136365,1216,134245,1658,2120,929,336273,2961,314162,4344,22111,3384,94630,1285,94239,1270,391,322
"Elk County, Pennsylvania",30455,267,6423,215,6370,233,53,92,17114,242,16384,466,730,358,6918,206,6918,206,0,189
"Erie County, Pennsylvania",261880,1173,59603,844,57243,2706,2360,2495,152835,1380,145196,2044,7639,1784,49442,693,49369,652,73,126
"Fayette County, Pennsylvania",123281,910,25416,423,24139,909,1277,861,70839,905,65086,1695,5753,1444,27026,373,27026,373,0,189
"Franklin County, Pennsylvania",154998,648,35846,787,29174,2910,6672,2872,88474,1136,78484,2603,9990,2567,30678,729,30026,546,652,584
"Greene County, Pennsylvania",33048,852,7182,462,7059,520,123,181,19062,703,16911,1061,2151,1087,6804,240,6728,229,76,119
"Huntingdon County, Pennsylvania",39979,989,8345,312,7934,384,411,279,22649,889,20568,1078,2081,688,8985,393,8948,399,37,62
"Indiana County, Pennsylvania",81544,383,17439,632,15981,781,1458,597,47479,644,43337,1577,4142,1340,16626,448,16513,473,113,109
"Jefferson County, Pennsylvania",43609,345,10147,342,8720,1157,1427,1033,24143,390,21358,747,2785,687,9319,278,9319,278,0,189
"Juniata County, Pennsylvania",23071,183,5426,240,4217,626,1209,592,13024,235,11022,663,2002,671,4621,172,4593,183,28,48
"Lackawanna County, Pennsylvania",212477,1108,46749,581,45449,1040,1300,904,123849,1190,115618,1981,8231,1607,41879,797,41764,808,115,115
"Lancaster County, Pennsylvania",547808,1325,136258,1049,116701,3991,19557,3866,310535,1255,272666,4752,37869,4471,101015,1233,98726,1644,2289,894
"Lawrence County, Pennsylvania",84789,369,18242,418,17132,1403,1110,1407,47597,492,43697,1131,3900,962,18950,451,18822,467,128,121
"Lebanon County, Pennsylvania",141168,750,34201,720,30703,1731,3498,1550,79352,954,72389,2419,6963,2165,27615,642,27584,644,31,52
"Lehigh County, Pennsylvania",371264,1016,90122,1199,87937,1765,2185,1327,219434,1518,194594,4069,24840,4102,61708,1193,61434,1207,274,321
"Luzerne County, Pennsylvania",319212,1570,69125,769,65908,1668,3217,1441,188529,1735,171335,2531,17194,2252,61558,795,61367,798,191,152
"Lycoming County, Pennsylvania",110561,922,24475,524,23387,741,1088,482,64277,1075,60656,1286,3621,896,21809,634,21734,635,75,98
"McKean County, Pennsylvania",37818,790,8517,292,8141,442,376,328,21747,716,20460,840,1287,511,7554,335,7554,335,0,189
"Mercer County, Pennsylvania",106581,985,21995,865,20535,1070,1460,789,60594,839,56356,1440,4238,1146,23992,433,23933,436,59,64
"Mifflin County, Pennsylvania",45350,576,11059,463,9794,904,1265,765,24750,578,22008,958,2742,763,9541,298,9478,326,63,85
"Monroe County, Pennsylvania",168277,1133,34317,978,33556,1112,761,622,102932,1929,95974,2607,6958,1970,31028,1266,31024,1267,4,10
"Montgomery County, Pennsylvania",846525,2710,192386,1057,187111,1710,5275,1469,502576,2733,475551,4878,27025,3454,151563,1067,150857,1116,706,380
"Northampton County, Pennsylvania",310488,1537,66947,806,65272,1224,1675,831,183264,1294,169623,2583,13641,2424,60277,1163,60041,1211,236,214
"Northumberland County, Pennsylvania",87676,958,18941,669,18280,836,661,428,49614,996,46980,1295,2634,777,19121,411,19086,411,35,57
"Perry County, Pennsylvania",45456,473,10179,201,8724,775,1455,733,26428,367,23565,994,2863,874,8849,446,8783,461,66,114
"Philadelphia County, Pennsylvania",1561969,2801,362374,2983,348975,4858,13399,3706,978366,2806,880733,9301,97633,9375,221229,1162,219383,1333,1846,741
"Pike County, Pennsylvania",59624,410,11413,658,10921,693,492,333,34574,937,32938,1166,1636,619,13637,533,13485,508,152,187
"Schuylkill County, Pennsylvania",135835,1700,30218,375,28161,1607,2057,1615,77600,1571,71504,1966,6096,1393,28017,436,27964,443,53,66
"Snyder County, Pennsylvania",38949,870,8942,547,7700,730,1242,538,22531,652,20019,824,2512,646,7476,591,7324,592,152,126
"Somerset County, Pennsylvania",69035,853,14272,122,12605,669,1667,650,38246,753,34366,1111,3880,870,16517,351,16394,398,123,198
"Susquehanna County, Pennsylvania",38137,182,7567,230,6803,481,764,481,21326,266,19212,642,2114,566,9244,174,9204,154,40,65
"Tioga County, Pennsylvania",40689,192,8726,237,8633,263,93,84,22761,236,20882,718,1879,652,9202,184,9173,190,29,49
"Union County, Pennsylvania",37391,1111,8774,439,7237,983,1537,834,20661,1094,18348,1265,2313,779,7956,382,7956,382,0,189
"Venango County, Pennsylvania",49315,588,9943,317,9754,358,189,183,27650,446,25204,823,2446,784,11722,327,11695,324,27,46
"Warren County, Pennsylvania",37561,413,7723,231,7108,423,615,359,20879,410,19423,586,1456,403,8959,295,8959,295,0,189
"Washington County, Pennsylvania",207594,838,44308,644,43371,892,937,561,120256,1150,114726,1937,5530,1412,43030,650,42829,596,201,252
"Wayne County, Pennsylvania",48003,878,8982,488,8827,517,155,180,26650,691,23370,1455,3280,1442,12371,283,12371,283,0,189
"Westmoreland County, Pennsylvania",349633,1103,68207,883,67752,874,455,287,200037,1491,189891,2147,10146,2004,81389,858,81250,875,139,231
"Wyoming County, Pennsylvania",25869,222,5271,211,5181,237,90,77,14846,233,14114,316,732,258,5752,228,5735,224,17,29
"York County, Pennsylvania",454456,1179,105548,1171,101803,1912,3745,1437,266898,1304,248770,2939,18128,2676,82010,970,81880,980,130,107
"Bristol County, Rhode Island",50228,374,10509,598,10360,625,149,146,29652,661,28780,811,872,477,10067,557,10067,557,0,232
"Kent County, Rhode Island",169651,416,33964,785,33547,787,417,367,102889,985,96425,2208,6464,2095,32798,736,32513,763,285,252
"Newport County, Rhode Island",81714,697,15583,914,15403,897,180,183,45630,1195,43224,1526,2406,925,20501,762,20394,764,107,127
"Providence County, Rhode Island",649420,559,143482,1517,138876,2699,4606,2224,405343,1553,378362,4647,26981,4473,100595,561,99434,966,1161,701
"Washington County, Rhode Island",129425,504,23507,509,23162,733,345,534,76892,777,73952,1275,2940,1022,29026,591,28994,589,32,62
"Abbeville County, South Carolina",24466,1574,5154,681,4609,901,545,401,13568,1523,11611,1365,1957,772,5744,834,5744,834,0,226
"Aiken County, South Carolina",169256,1067,40079,1230,38352,1463,1727,1168,94215,1640,79634,3111,14581,2770,34962,719,34791,731,171,203
"Anderson County, South Carolina",205760,559,50010,930,47788,1180,2222,907,118362,1137,97523,3475,20839,3489,37388,323,37042,414,346,331
"Barnwell County, South Carolina",20168,517,4548,1011,4275,1020,273,305,11154,1163,8414,1220,2740,977,4466,847,4466,847,0,226
"Beaufort County, South Carolina",182183,1788,36407,1196,32412,2136,3995,2076,90903,2176,74094,3155,16809,2817,54873,695,54659,703,214,355
"Berkeley County, South Carolina",228332,2223,59407,1188,55651,1819,3756,1399,134621,2412,119978,3109,14643,2211,34304,597,33895,715,409,443
"Charleston County, South Carolina",408329,1974,84100,1186,80004,2314,4096,2225,252195,2607,221924,4106,30271,3554,72034,932,71029,682,1005,1066
"Cherokee County, South Carolina",55245,647,13336,381,12727,585,609,484,31827,722,27197,1301,4630,1297,10082,493,10082,493,0,226
"Chester County, South Carolina",31822,324,7597,303,6909,602,688,524,18045,430,15111,1198,2934,1252,6180,226,6180,226,0,226
"Chesterfield County, South Carolina",42889,228,9945,280,9922,277,23,44,24471,464,20197,1230,4274,1030,8473,446,8473,446,0,226
"Clarendon County, South Carolina",29679,477,6215,670,5696,948,519,501,15753,971,12305,1035,3448,1235,7711,146,7711,146,0,226
"Colleton County, South Carolina",38147,362,9379,491,7751,762,1628,809,20997,713,15520,1925,5477,2007,7771,751,7547,785,224,240
"Darlington County, South Carolina",62276,359,14768,748,13658,892,1110,762,34725,771,28830,1782,5895,1593,12783,509,12783,509,0,226
"Dillon County, South Carolina",27851,243,8277,977,7760,1122,517,517,14279,996,11999,1259,2280,835,5295,859,5295,859,0,226
"Dorchester County, South Carolina",160602,924,40751,667,37145,2791,3606,2744,95888,1154,83759,3327,12129,3084,23963,533,23963,533,0,226
"Edgefield County, South Carolina",23559,1321,5607,815,5497,856,110,147,13577,1442,11599,1472,1978,1241,4375,818,4375,818,0,226
"Fairfield County, South Carolina",20464,233,4249,976,4249,976,0,226,11727,1118,10483,1237,1244,1000,4488,992,4488,992,0,226
"Florence County, South Carolina",134842,737,33987,755,32240,1208,1747,994,76917,898,65969,2283,10948,2268,23938,375,23758,389,180,264
"Georgetown County, South Carolina",63402,394,11592,692,11339,787,253,404,32996,700,26419,1722,6577,1612,18814,310,18814,310,0,226
"Greenville County, South Carolina",529563,1293,128931,1048,122479,2020,6452,1879,314050,1740,268387,5290,45663,5110,86582,1019,86062,1152,520,414
"Greenwood County, South Carolina",68603,403,16903,607,16118,871,785,617,38490,950,33081,1651,5409,1390,13210,727,13153,736,57,101
"Horry County, South Carolina",364129,904,67100,991,63328,1662,3772,1472,202372,1388,157376,4302,44996,4235,94657,939,93931,1113,726,592
"Jasper County, South Carolina",29838,514,4366,794,4096,994,270,451,17724,899,14056,1814,3668,1462,7748,855,7748,855,0,226
"Kershaw County, South Carolina",65486,422,16301,1142,15702,1147,599,511,36987,1221,30919,1781,6068,1599,12198,258,12095,321,103,165
"Lancaster County, South Carolina",98946,690,22918,745,21722,1081,1196,731,54822,948,48039,2218,6783,2031,21206,475,21022,538,184,279
"Laurens County, South Carolina",66751,679,15293,500,15131,529,162,184,39383,594,30893,1603,8490,1632,12075,374,11949,336,126,182
"Lexington County, South Carolina",297674,1595,72217,615,68829,1540,3388,1405,176262,1538,152469,3399,23793,3350,49195,424,49173,424,22,32
"Marion County, South Carolina",28653,138,7143,511,7143,511,0,226,15547,511,12299,1292,3248,1222,5963,138,5963,138,0,226
"Marlboro County, South Carolina",23485,1326,4894,1082,4894,1082,0,226,13601,1606,10839,1492,2762,1149,4990,1103,4990,1103,0,226
"Newberry County, South Carolina",37674,283,8457,240,8374,244,83,123,21693,282,18605,1336,3088,1252,7524,204,7488,201,36,53
"Oconee County, South Carolina",78680,381,15590,648,14369,952,1221,933,44135,903,36149,1903,7986,2094,18955,635,18930,643,25,46
"Orangeburg County, South Carolina",82462,189,19746,698,18628,714,1118,615,45586,764,36393,2216,9193,2179,17130,444,17130,444,0,226
"Pickens County, South Carolina",131429,285,29136,1306,27417,1520,1719,981,80247,1352,69287,2764,10960,2248,22046,333,21964,351,82,96
"Richland County, South Carolina",400296,2796,98452,1607,93875,1973,4577,1455,246058,2910,218771,4300,27287,3524,55786,908,55617,951,169,201
"Spartanburg County, South Carolina",331360,890,82351,836,77340,2220,5011,2080,195676,1326,167510,3240,28166,3085,53333,791,53057,813,276,261
"Sumter County, South Carolina",99544,1375,26565,1112,25917,1239,648,501,55253,1679,47406,1925,7847,1467,17726,396,17708,400,18,31
"Union County, South Carolina",26663,207,6117,270,6074,289,43,75,15176,375,12199,992,2977,937,5370,276,5370,276,0,226
"Williamsburg County, South Carolina",28569,1036,5418,909,5418,909,0,226,16793,1105,14247,1163,2546,1018,6358,842,6358,842,0,226
"York County, South Carolina",286792,1128,71928,827,68993,1387,2935,1041,172048,1435,152484,3042,19564,2882,42816,557,42697,602,119,193
"Brookings County, South Dakota",34284,305,8453,746,8396,762,57,87,21547,800,20474,908,1073,483,4284,137,4284,137,0,170
"Brown County, South Dakota",37616,234,9880,579,9588,585,292,248,21118,646,18826,1097,2292,844,6618,342,6618,342,0,170
"Codington County, South Dakota",28074,322,7232,455,6746,514,486,303,15812,485,15161,637,651,350,5030,258,4997,264,33,53
"Davison County, South Dakota",21875,1814,5941,826,5291,714,650,717,12314,1395,11894,1392,420,395,3620,477,3620,477,0,170
"Lawrence County, South Dakota",26190,2096,4449,830,4202,940,247,396,15678,1452,13414,1469,2264,832,6063,978,6063,978,0,170
"Lincoln County, South Dakota",67643,143,19512,706,18886,833,626,564,38781,715,35891,1483,2890,1202,9350,101,9350,101,0,170
"Meade County, South Dakota",28135,2540,7500,1286,6884,1469,616,773,15982,1563,14550,1443,1432,695,4653,632,4653,632,0,170
"Minnehaha County, South Dakota",196085,1391,52036,723,49102,1602,2934,1429,116917,1680,101912,2948,15005,2629,27132,769,27132,769,0,170
"Pennington County, South Dakota",109053,1030,26270,849,23390,1341,2880,1184,61339,1363,51659,2215,9680,1930,21444,729,21444,729,0,170
"Yankton County, South Dakota",22028,2124,5035,950,4905,914,130,216,12353,1564,11699,1568,654,350,4640,927,4640,927,0,170
"Anderson County, Tennessee",76370,1007,17374,300,16266,689,1108,641,43397,1191,36005,2065,7392,1831,15599,475,15338,326,261,358
"Bedford County, Tennessee",50606,478,13396,825,11085,1130,2311,1249,29486,1076,23821,1788,5665,1402,7724,652,7724,652,0,224
"Blount County, Tennessee",136597,995,29240,703,27619,1114,1621,847,78984,1239,68008,2639,10976,2421,28373,411,28244,474,129,222
"Bradley County, Tennessee",109267,1048,25300,710,24521,903,779,598,65273,1268,54069,1957,11204,2011,18694,406,18587,422,107,129
"Campbell County, Tennessee",38948,484,8483,332,8373,366,110,153,22571,527,18078,1525,4493,1473,7894,188,7894,188,0,224
"Carroll County, Tennessee",28023,282,6777,379,6470,137,307,374,15573,540,13166,1245,2407,942,5673,381,5576,400,97,95
"Carter County, Tennessee",55101,786,10821,574,10635,553,186,208,31897,916,25676,1715,6221,1572,12383,227,12383,227,0,224
"Cheatham County, Tennessee",41281,242,8445,507,8350,525,95,173,26079,689,21162,1413,4917,1520,6757,480,6757,480,0,224
"Claiborne County, Tennessee",31822,399,6327,248,6267,247,60,90,19235,358,16259,1017,2976,966,6260,104,6260,104,0,224
"Cocke County, Tennessee",36064,289,8352,989,7711,624,641,805,19889,960,15950,1623,3939,1379,7823,444,7823,444,0,224
"Coffee County, Tennessee",58638,347,14672,639,13795,716,877,572,33670,885,29256,1554,4414,1298,10296,568,10218,579,78,124
"Cumberland County, Tennessee",62027,366,10421,491,9458,786,963,617,31281,694,26495,1335,4786,1295,20325,450,20283,441,42,71
"Davidson County, Tennessee",696196,1909,150255,1597,138439,2850,11816,2471,454951,1978,379904,5760,75047,5891,90990,930,89588,927,1402,874
"DeKalb County, Tennessee",20303,271,3912,1053,3789,1005,123,197,11962,1252,9341,1463,2621,1103,4429,948,4429,948,0,224
"Dickson County, Tennessee",54862,775,12282,266,12259,265,23,44,33470,812,29371,1384,4099,1311,9110,266,9110,266,0,224
"Dyer County, Tennessee",36163,446,9509,535,9298,572,211,275,20347,785,16427,1603,3920,1444,6307,416,6307,416,0,224
"Fayette County, Tennessee",42436,265,8143,475,7899,493,244,164,24652,504,21340,892,3312,885,9641,353,9537,387,104,129
"Franklin County, Tennessee",42818,515,9359,976,8801,1017,558,517,24536,1126,19592,1565,4944,1263,8923,457,8923,457,0,224
"Gibson County, Tennessee",49576,765,12614,491,12391,498,223,205,28353,907,25039,1292,3314,1100,8609,463,8609,463,0,224
"Giles County, Tennessee",30255,331,6868,279,6811,300,57,110,17003,454,16040,751,963,569,6384,353,6370,360,14,25
"Grainger County, Tennessee",23645,245,4520,964,4475,959,45,80,14489,951,11763,1335,2726,1230,4636,943,4636,943,0,224
"Greene County, Tennessee",69644,583,13721,478,13426,618,295,412,40473,757,35821,1439,4652,1198,15450,371,15450,371,0,224
"Hamblen County, Tennessee",63825,731,16427,1326,15619,1801,808,1086,35436,1098,26901,2161,8535,2083,11962,799,11962,799,0,224
"Hamilton County, Tennessee",365415,1237,81613,1098,78654,1513,2959,1273,218550,1595,186750,3789,31800,3688,65252,941,64442,973,810,566
"Hardeman County, Tennessee",21333,4218,5068,321,4814,449,254,311,11678,4023,9950,3038,1728,1287,4587,311,4587,311,0,224
"Hardin County, Tennessee",26385,322,5049,290,4832,419,217,281,15564,482,11707,1286,3857,1284,5772,418,5772,418,0,224
"Hawkins County, Tennessee",56838,612,11728,739,11257,810,471,372,33080,783,28113,1191,4967,1056,12030,267,12030,267,0,224
"Henderson County, Tennessee",27547,520,6819,611,6413,590,406,440,15778,901,11981,1503,3797,1080,4950,539,4896,552,54,94
"Henry County, Tennessee",31893,269,7100,506,6212,731,888,733,17607,615,13060,1265,4547,1109,7186,413,7186,413,0,224
"Hickman County, Tennessee",23722,812,5688,1155,5329,1038,359,445,13949,1226,12648,1318,1301,679,4085,1050,4085,1050,0,224
"Jefferson County, Tennessee",54774,642,11497,950,11497,950,0,224,32518,1074,27806,1584,4712,1292,10759,358,10759,358,0,224
"Johnson County, Tennessee",18290,2188,4068,917,3837,966,231,270,9888,1530,8320,1381,1568,851,4334,722,4334,722,0,224
"Knox County, Tennessee",483561,660,108563,1509,106035,1574,2528,921,297453,1698,262449,3557,35004,3267,77545,917,76894,919,651,521
"Lauderdale County, Tennessee",22594,860,6312,830,6241,840,71,81,12847,1096,10957,1147,1890,500,3435,685,3400,680,35,60
"Lawrence County, Tennessee",44385,492,12087,563,11575,670,512,539,24459,730,21454,1301,3005,1110,7839,372,7839,372,0,224
"Lincoln County, Tennessee",34970,473,8609,668,7850,844,759,525,19883,685,15970,1261,3913,1341,6478,493,6478,493,0,224
"Loudon County, Tennessee",56420,310,12281,796,12198,776,83,136,28772,869,27314,1135,1458,576,15367,313,15192,426,175,280
"McMinn County, Tennessee",53193,677,12020,884,11301,817,719,609,30849,1200,25598,1705,5251,1514,10324,289,10324,289,0,224
"McNairy County, Tennessee",25556,292,5953,186,5603,417,350,392,13653,418,11234,765,2419,705,5950,323,5950,323,0,224
"Macon County, Tennessee",25488,329,7655,1078,7655,1078,0,224,14651,1264,13037,1479,1614,910,3182,1067,3182,1067,0,224
"Madison County, Tennessee",97260,957,23832,967,23260,1074,572,507,56597,1072,50636,1770,5961,1513,16831,326,16790,356,41,68
"Marion County, Tennessee",28767,236,6810,456,6760,460,50,86,15963,450,14577,653,1386,581,5994,255,5994,255,0,224
"Marshall County, Tennessee",34768,283,8493,364,8382,408,111,197,20316,519,17451,1209,2865,1133,5959,438,5916,449,43,60
"Maury County, Tennessee",103803,832,25061,604,23539,1352,1522,1265,61660,1194,56822,2143,4838,1729,17082,835,17082,835,0,224
"Monroe County, Tennessee",46111,773,10408,629,10408,629,0,224,25737,1040,21317,1379,4420,1194,9966,314,9966,314,0,224
"Montgomery County, Tennessee",213272,2410,63384,821,60733,1535,2651,1285,128355,2368,111132,3806,17223,2986,21533,823,21533,823,0,224
"Morgan County, Tennessee",19051,917,2977,987,2899,983,78,131,10528,1089,9280,1115,1248,612,5546,1093,5546,1093,0,224
"Obion County, Tennessee",30105,390,7000,430,6500,567,500,349,17024,593,14683,899,2341,748,6081,225,6081,225,0,224
"Overton County, Tennessee",22648,293,4264,1085,4264,1085,0,224,13237,984,11437,1131,1800,685,5147,1029,5124,1028,23,40
"Putnam County, Tennessee",80404,598,17369,563,15966,1439,1403,1401,49404,1015,42514,1826,6890,1683,13631,734,13509,701,122,206
"Rhea County, Tennessee",33046,138,8244,1091,7849,1239,395,350,17767,1409,15190,1367,2577,1077,7035,769,7035,769,0,224
"Roane County, Tennessee",53497,502,10636,746,10122,783,514,334,30691,907,24507,1606,6184,1514,12170,348,12092,365,78,128
"Robertson County, Tennessee",73449,852,18265,334,17414,814,851,827,43731,878,38403,1507,5328,1333,11453,446,11453,446,0,224
"Rutherford County, Tennessee",350596,676,91365,1595,87645,2311,3720,1379,220491,1764,198124,3709,22367,3690,38740,731,38603,746,137,219
"Scott County, Tennessee",21680,297,4851,909,4676,918,175,237,13222,1057,11074,1243,2148,816,3607,821,3607,821,0,224
"Sevier County, Tennessee",98552,689,21477,759,19993,978,1484,760,57273,977,44797,2132,12476,2120,19802,301,19595,424,207,354
"Shelby County, Tennessee",912516,5099,242502,2018,225455,3724,17047,3067,537878,4850,446773,6723,91105,6619,132136,667,130362,964,1774,678
"Smith County, Tennessee",20107,3968,2926,1246,2881,1242,45,70,13037,2972,11499,2735,1538,802,4144,935,4144,935,0,224
"Sullivan County, Tennessee",156766,1249,31670,572,31264,687,406,370,90056,1165,76800,3140,13256,2882,35040,571,35003,573,37,65
"Sumner County, Tennessee",199120,930,49169,773,47178,1244,1991,1066,117408,1510,102651,2667,14757,2411,32543,739,32444,735,99,115
"Tipton County, Tennessee",60061,909,15514,569,14788,695,726,425,35224,991,31370,1542,3854,1075,9323,211,9323,211,0,224
"Union County, Tennessee",19498,2038,5354,1255,5100,1321,254,280,11187,1470,9502,1508,1685,732,2957,793,2957,793,0,224
"Warren County, Tennessee",41156,358,10233,508,9925,660,308,343,23561,595,19524,1240,4037,1132,7362,432,7292,377,70,127
"Washington County, Tennessee",132563,707,27199,997,26128,949,1071,732,80647,1186,68665,2827,11982,2476,24717,407,24717,407,0,224
"Weakley County, Tennessee",32692,310,7004,415,6905,416,99,132,19740,506,16673,882,3067,790,5948,361,5896,343,52,83
"White County, Tennessee",27314,373,6548,879,5416,1163,1132,1080,15534,1176,12200,1464,3334,1251,5232,967,5156,975,76,97
"Williamson County, Tennessee",255305,273,70767,812,68911,1459,1856,1485,148301,1110,141474,2951,6827,2536,36237,887,36237,887,0,224
"Wilson County, Tennessee",150860,1101,37329,925,36188,1466,1141,1087,89436,1096,79760,2410,9676,2392,24095,572,23848,619,247,323
"Anderson County, Texas",47322,2957,11960,851,10628,1252,1332,787,26632,2796,19502,2712,7130,1938,8730,547,8730,547,0,249
"Angelina County, Texas",84745,1172,22953,546,18941,1450,4012,1607,46941,1171,31790,2700,15151,2475,14851,818,14625,744,226,252
"Aransas County, Texas",20908,3274,1852,1010,1416,648,436,728,10746,2625,8574,2297,2172,1363,8310,1366,8262,1336,48,85
"Atascosa County, Texas",49653,131,13960,709,13109,965,851,656,28738,1033,21478,1804,7260,1879,6955,692,6955,692,0,249
"Austin County, Texas",30178,168,8012,1066,5884,989,2128,1119,15658,1090,12082,1551,3576,1124,6508,1017,6508,1017,0,249
"Bandera County, Texas",21425,155,3125,1054,3054,1052,71,133,11558,1228,9681,1305,1877,702,6742,1332,6742,1332,0,249
"Bastrop County, Texas",99945,1511,26085,1579,19710,4402,6375,3959,57090,2565,41367,5188,15723,4595,16770,1601,16770,1601,0,249
"Bee County, Texas",24208,3219,7617,1105,6186,1202,1431,798,13460,2538,10423,2224,3037,1319,3131,543,3131,543,0,249
"Bell County, Texas",353278,3717,109054,1333,100890,2648,8164,2449,202013,3896,166455,5408,35558,4521,42211,567,41437,741,774,626
"Bexar County, Texas",1986325,9030,534586,2277,485484,7854,49102,7387,1200707,8956,922759,11535,277948,10635,251032,917,248449,1359,2583,1006
"Bowie County, Texas",87077,1918,23939,1045,20605,1712,3334,1618,48317,2078,36044,2534,12273,2017,14821,483,14724,442,97,156
"Brazoria County, Texas",367093,5270,102674,1528,94355,3211,8319,2695,217793,5360,178181,6205,39612,5707,46626,582,46095,715,531,436
"Brazos County, Texas",232014,2353,55913,1604,51222,2526,4691,1890,152429,3002,125998,3465,26431,3790,23672,757,23627,753,45,77
"Brown County, Texas",37336,663,8389,532,7216,663,1173,546,21338,597,15513,1417,5825,1247,7609,409,7591,407,18,33
"Burnet County, Texas",50117,1125,10346,433,9522,634,824,530,28281,1120,21880,1574,6401,1484,11490,691,11447,693,43,71
"Caldwell County, Texas",45155,714,11046,627,8755,1423,2291,1239,26614,1019,17690,2068,8924,2015,7495,649,7359,666,136,208
"Calhoun County, Texas",19510,237,3273,841,3273,841,0,249,11913,1028,10519,1444,1394,945,4324,845,4324,845,0,249
"Cameron County, Texas",421819,315,130429,1214,106442,4141,23987,4130,233058,1278,138081,6741,94977,6411,58332,307,56761,897,1571,872
"Cass County, Texas",28274,161,7169,338,7005,375,164,235,14977,397,12040,1018,2937,1001,6128,243,6090,258,38,67
"Chambers County, Texas",48682,268,13399,786,12697,1162,702,823,28902,1218,19031,2208,9871,2294,6381,974,6381,974,0,249
"Cherokee County, Texas",48688,874,13383,538,11647,878,1736,747,26843,1012,17392,1902,9451,1874,8462,594,8355,575,107,179
"Collin County, Texas",1106407,2271,293745,1773,274527,4425,19218,4555,687742,3161,606490,7907,81252,7534,124920,459,122748,1058,2172,989
"Colorado County, Texas",20348,275,4680,1678,4435,1769,245,399,9661,1451,7715,1243,1946,1439,6007,892,6007,892,0,249
"Comal County, Texas",173173,1039,40819,1444,37478,2123,3341,1769,100973,1884,83385,4150,17588,3645,31381,427,31081,508,300,432
"Cooke County, Texas",41954,256,10306,870,8851,1126,1455,1011,23052,1072,15628,1726,7424,1744,8596,885,8581,883,15,27
"Coryell County, Texas",62983,1912,19415,412,18358,821,1057,648,34956,2016,29000,1925,5956,1465,8612,793,8612,793,0,249
"Dallas County, Texas",2568451,6633,690987,3338,581535,9121,109452,8589,1584200,6623,1135403,14946,448797,15849,293264,841,285245,1808,8019,1644
"Denton County, Texas",938213,1665,235511,1638,222978,3024,12533,2824,599792,2033,521022,7850,78770,7225,102910,1071,100926,1364,1984,908
"DeWitt County, Texas",18185,764,5204,1230,4754,1227,450,480,10748,1253,6899,1227,3849,1083,2233,773,2233,773,0,249
"Ector County, Texas",159726,1131,50401,887,35156,3908,15245,3956,93098,1372,64751,5089,28347,5261,16227,428,16160,447,67,87
"Ellis County, Texas",201531,1092,56085,882,48563,2514,7522,2307,119021,1459,95243,3524,23778,3580,26425,803,25725,991,700,499
"El Paso County, Texas",842081,3501,245054,1943,218089,5409,26965,5118,487606,3504,338517,7731,149089,7757,109421,581,105160,1506,4261,1405
"Erath County, Texas",42958,258,10527,714,9147,947,1380,817,26197,919,20597,2242,5600,2109,6234,640,6234,640,0,249
"Fannin County, Texas",33500,2130,8387,428,7672,524,715,350,18571,2011,14349,1414,4222,1359,6542,332,6478,341,64,92
"Fayette County, Texas",24377,206,5541,365,3921,944,1620,1012,12647,417,10705,922,1942,1032,6189,270,6138,283,51,87
"Fort Bend County, Texas",853228,2038,241585,1938,215488,6608,26097,7245,508675,2899,430340,10939,78335,10826,102968,483,101002,1160,1966,1012
"Gaines County, Texas",21814,131,6761,1491,5370,1419,1391,1108,13230,1347,9893,1806,3337,1202,1823,917,1823,917,0,249
"Galveston County, Texas",350177,1453,89429,831,80200,3375,9229,3377,208031,1680,168686,4793,39345,4604,52717,772,52501,793,216,213
"Gillespie County, Texas",27089,134,5478,725,4440,941,1038,643,12607,961,9772,1290,2835,979,9004,1087,8741,1076,263,282
"Gonzales County, Texas",21589,1231,7249,955,6242,975,1007,612,11489,1156,7098,1279,4391,1398,2851,835,2851,835,0,249
"Gray County, Texas",19659,2206,5283,1074,4513,975,770,640,11362,1625,7592,1308,3770,961,3014,523,3014,523,0,249
"Grayson County, Texas",138594,682,34827,817,30462,2122,4365,1756,78394,1447,61198,3174,17196,2779,25373,824,25279,821,94,164
"Gregg County, Texas",122313,1370,33618,862,29172,1687,4446,1636,70123,1972,52588,3291,17535,2740,18572,669,18357,682,215,203
"Grimes County, Texas",28048,3677,6850,1596,5750,1138,1100,914,15310,2769,11229,2530,4081,1732,5888,747,5888,747,0,249
"Guadalupe County, Texas",174256,1416,45595,1027,42362,1547,3233,1088,103199,1986,86393,3752,16806,3356,25462,700,25057,969,405,534
"Hale County, Texas",30438,1011,8891,536,7558,972,1333,834,17167,1049,11919,1485,5248,1343,4380,284,4380,284,0,249
"Hardin County, Texas",56633,249,14938,599,13628,1059,1310,942,31992,753,25572,1909,6420,1786,9703,487,9703,487,0,249
"Harris County, Texas",4699541,11458,1296996,4229,1107890,19056,189106,18621,2870201,10962,2048750,24686,821451,21736,532344,909,517517,3073,14827,2801
"Harrison County, Texas",68440,461,18769,695,16392,1448,2377,1204,37520,1043,29159,2133,8361,1944,12151,675,11743,613,408,379
"Hays County, Texas",253110,1562,63531,1255,59629,2279,3902,2024,159882,1925,130942,4959,28940,5012,29697,748,29697,748,0,249
"Henderson County, Texas",82806,1075,18871,487,16980,1286,1891,1209,45331,1335,34676,2678,10655,2378,18604,726,18579,730,25,43
"Hidalgo County, Texas",873479,2357,296354,1981,252710,6711,43644,6529,478305,2865,259880,10134,218425,9948,98820,742,94002,1769,4818,1672
"Hill County, Texas",35802,391,8860,317,7539,714,1321,615,19682,500,14859,1060,4823,975,7260,406,7246,415,14,23
"Hockley County, Texas",21191,143,5858,213,4563,659,1295,598,12132,502,8580,742,3552,891,3201,409,3146,419,55,93
"Hood County, Texas",63480,582,13623,460,11160,1514,2463,1527,33296,656,26639,1888,6657,1637,16561,511,16411,497,150,166
"Hopkins County, Texas",36759,328,9648,260,8267,660,1381,589,20544,465,14663,1010,5881,1023,6567,349,6558,349,9,19
"Houston County, Texas",18932,1025,3730,847,3244,849,486,393,9605,1185,7198,1227,2407,961,5597,977,5597,977,0,249
"Howard County, Texas",31770,1016,7996,550,7695,636,301,314,19027,1023,13794,2061,5233,1867,4747,447,4747,447,0,249
"Hunt County, Texas",102681,731,26173,524,24306,1020,1867,932,60323,1098,43968,2678,16355,2454,16185,737,16090,756,95,128
"Hutchinson County, Texas",20496,1746,5670,1004,5029,1050,641,378,10836,1185,8978,1311,1858,786,3990,559,3970,558,20,41
"Jasper County, Texas",32360,464,7651,462,7009,740,642,504,18147,684,11207,1936,6940,1743,6562,375,6562,375,0,249
"Jefferson County, Texas",239552,2364,65904,1313,57501,2288,8403,2179,135929,2921,93365,4134,42564,3890,37719,614,36995,992,724,824
"Jim Wells County, Texas",38515,308,10925,351,8411,1264,2514,1247,21718,765,12857,2661,8861,2446,5872,596,5872,596,0,249
"Johnson County, Texas",184672,2942,50547,702,43329,2537,7218,2513,109495,2941,86651,5005,22844,4178,24630,545,24100,754,530,447
"Jones County, Texas",15460,2350,4092,981,4009,1033,83,94,7897,1453,5532,1234,2365,957,3471,709,3457,708,14,19
"Kaufman County, Texas",156769,853,46797,1069,40093,2516,6704,2286,92064,1750,73520,4140,18544,3507,17908,1040,17496,1049,412,458
"Kendall County, Texas",46256,432,10845,588,9794,775,1051,697,26891,898,22800,1505,4091,1384,8520,499,8234,435,286,331
"Kerr County, Texas",52212,705,10711,617,8840,1032,1871,878,26798,987,19551,1714,7247,1466,14703,754,14636,776,67,79
"Kleberg County, Texas",32253,2032,9062,1091,8956,1060,106,160,19234,1891,14857,2447,4377,2220,3957,768,3957,768,0,249
"Lamar County, Texas",49697,316,13440,715,11439,822,2001,809,27074,857,18520,1970,8554,1963,9183,441,9183,441,0,249
"Lampasas County, Texas",22254,2104,5105,1008,4463,1105,642,507,12437,1598,9322,1459,3115,1062,4712,883,4712,883,0,249
"Lavaca County, Texas",20202,214,4705,846,3899,878,806,628,11552,974,8780,1046,2772,865,3945,911,3945,911,0,249
"Liberty County, Texas",92919,1003,30754,1337,25301,2442,5453,2907,48290,1506,33262,2457,15028,2312,13875,673,13875,673,0,249
"Limestone County, Texas",19627,2179,4639,1023,3751,997,888,680,10545,1308,7256,1189,3289,879,4443,700,4443,700,0,249
"Llano County, Texas",21837,114,3676,792,3117,849,559,384,11050,937,7356,1260,3694,922,7111,1150,6948,1177,163,187
"Lubbock County, Texas",310430,1446,83055,1510,77228,2654,5827,2075,187289,2018,151693,3686,35596,3969,40086,551,39772,620,314,312
"McLennan County, Texas",258620,1356,70275,1101,64849,2106,5426,1678,150152,1552,118039,3588,32113,3637,38193,471,37703,596,490,414
"Matagorda County, Texas",36086,228,9077,1002,8792,1077,285,361,19548,1342,11766,2688,7782,2603,7461,862,7461,862,0,249
"Maverick County, Texas",57766,523,18750,899,16501,1072,2249,1115,32313,1032,20033,2681,12280,2506,6703,214,6674,201,29,68
"Medina County, Texas",49765,810,12789,740,11324,1123,1465,986,27706,1082,21874,2245,5832,2073,9270,501,9043,548,227,293
"Midland County, Texas",166728,1036,49233,1726,45112,2374,4121,2045,100858,2262,82935,4171,17923,4253,16637,718,16320,585,317,300
"Milam County, Texas",24792,312,5929,227,4994,584,935,522,13979,484,11950,929,2029,717,4884,489,4884,489,0,249
"Montague County, Texas",20950,1329,5350,740,5072,820,278,304,11579,958,9005,1336,2574,966,4021,699,3999,698,22,47
"Montgomery County, Texas",646823,1628,177933,1951,162047,5222,15886,5098,380248,2551,299551,7800,80697,7796,88642,1177,86950,1550,1692,1045
"Moore County, Texas",20082,2202,5761,1187,5431,1190,330,383,11852,1420,8060,1616,3792,1473,2469,632,1702,440,767,528
"Nacogdoches County, Texas",64013,486,17671,1225,17173,1283,498,407,36632,1245,29402,1717,7230,1564,9710,623,9624,637,86,128
"Navarro County, Texas",52899,605,15203,591,13634,1142,1569,986,27902,1035,17476,1827,10426,1490,9794,716,9701,719,93,117
"Nueces County, Texas",347068,1496,90754,1423,83577,2686,7177,2314,203172,1728,146122,5403,57050,5186,53142,879,52078,1204,1064,679
"Orange County, Texas",84196,378,22695,608,21609,830,1086,776,48229,815,37342,2298,10887,2148,13272,702,13211,695,61,106
"Palo Pinto County, Texas",28444,259,6766,468,6538,514,228,257,15944,536,10410,1276,5534,1408,5734,280,5734,280,0,249
"Panola County, Texas",22544,138,5875,913,5451,862,424,477,12562,935,8631,1295,3931,1079,4107,952,3364,883,743,551
"Parker County, Texas",155704,1298,40312,644,36921,1562,3391,1319,91098,1435,73614,3027,17484,3033,24294,662,23648,595,646,761
"Polk County, Texas",48832,1209,10988,429,10186,777,802,599,27882,1250,21708,1557,6174,1395,9962,348,9933,354,29,44
"Potter County, Texas",108331,4109,32634,778,28553,1391,4081,1402,61561,3636,45612,3313,15949,3012,14136,808,14010,783,126,150
"Randall County, Texas",143014,1113,36538,1146,33781,1760,2757,1323,84699,1331,69743,2490,14956,2745,21777,555,21777,555,0,249
"Rockwall County, Texas",115768,462,32032,715,29561,2126,2471,1957,68087,975,58959,2662,9128,2631,15649,750,15383,742,266,286
"Rusk County, Texas",49832,1768,11939,265,11290,640,649,582,29217,1826,23778,1874,5439,1449,8676,426,8650,421,26,57
"San Jacinto County, Texas",27751,203,6061,1269,5070,1230,991,570,16041,1164,11387,1692,4654,1436,5649,1482,5635,1481,14,23
"San Patricio County, Texas",69119,467,19633,815,17287,1611,2346,1420,39211,918,28432,1686,10779,1782,10275,366,10132,372,143,137
"Shelby County, Texas",24840,2363,7174,657,6020,938,1154,865,12840,1885,8845,1631,3995,1248,4826,877,4608,760,218,390
"Smith County, Texas",233904,1318,62526,1297,55244,2412,7282,2298,131655,1495,97637,4406,34018,4219,39723,398,38840,760,883,642
"Starr County, Texas",65479,592,22875,1110,18233,2202,4642,1887,35644,1055,18633,2963,17011,2832,6960,104,6852,170,108,144
"Tarrant County, Texas",2110007,5279,577315,2686,503516,7065,73799,7120,1282716,5544,978833,13002,303883,11869,249976,583,246636,1222,3340,1205
"Taylor County, Texas",138415,1713,37240,1080,32501,1941,4739,1736,80929,1952,62118,3079,18811,3161,20246,689,20198,687,48,74
"Titus County, Texas",30987,169,9758,827,7577,1040,2181,823,17252,952,11831,1414,5421,1377,3977,461,3977,461,0,249
"Tom Green County, Texas",115248,1707,30252,1029,25585,1898,4667,1758,66232,1977,50282,3010,15950,2847,18764,394,18639,411,125,155
"Travis County, Texas",1295885,3201,284165,2254,261803,6320,22362,5761,875460,3815,738352,11689,137108,11425,136260,751,133882,1325,2378,968
"Tyler County, Texas",18650,755,3864,1182,3210,1164,654,584,10421,1280,7214,1242,3207,1085,4365,1107,4365,1107,0,249
"Upshur County, Texas",41434,270,10339,382,9397,736,942,655,23811,554,17649,1713,6162,1499,7284,376,7284,376,0,249
"Uvalde County, Texas",26116,1099,8030,382,7610,219,420,423,13731,1159,11121,1296,2610,919,4355,416,4355,416,0,249
"Val Verde County, Texas",44829,992,13533,340,11806,1135,1727,1092,24871,1054,18799,2285,6072,2067,6425,443,6078,547,347,347
"Van Zandt County, Texas",60858,386,15523,730,13612,1485,1911,1219,32955,996,25030,1755,7925,1779,12380,617,12103,574,277,333
"Victoria County, Texas",90239,512,23839,693,22356,1115,1483,990,51648,919,38488,2514,13160,2717,14752,449,14643,479,109,130
"Walker County, Texas",65709,6211,13719,1214,12212,1426,1507,1035,41322,5295,31683,4041,9639,3361,10668,959,10668,959,0,249
"Waller County, Texas",59681,158,16423,1081,11419,2079,5004,1973,32821,2046,22121,2338,10700,2051,10437,1759,9930,1626,507,603
"Washington County, Texas",34894,641,7909,1297,6220,1447,1689,1165,18471,1339,14122,1974,4349,1401,8514,1205,8514,1205,0,249
"Webb County, Texas",266950,573,88795,1015,77099,2867,11696,2732,151190,1396,88953,5088,62237,5183,26965,825,24729,1212,2236,810
"Wharton County, Texas",41480,186,10647,774,10423,834,224,361,22863,1035,18481,2094,4382,2229,7970,910,7970,910,0,249
"Wichita County, Texas",117931,2529,30695,627,29101,747,1594,607,68379,2387,54081,2531,14298,2170,18857,569,18690,593,167,166
"Willacy County, Texas",20026,2964,6284,1834,5337,1758,947,702,10532,1702,5718,1449,4814,1560,3210,796,3159,782,51,84
"Williamson County, Texas",640777,1617,164602,1775,153504,2932,11098,2657,395719,2363,336914,6721,58805,6493,80456,343,79299,807,1157,711
"Wilson County, Texas",50799,276,13241,701,12333,920,908,687,29268,651,24032,1471,5236,1520,8290,341,8235,354,55,93
"Wise County, Texas",70887,1397,18721,704,16613,1225,2108,1031,41230,1512,32090,1697,9140,1870,10936,486,10919,482,17,31
"Wood County, Texas",45168,533,9129,432,8540,463,589,362,23853,763,17379,1704,6474,1503,12186,363,12186,363,0,249
"Box Elder County, Utah",59393,276,19078,231,17877,813,1201,691,33059,332,28668,1383,4391,1460,7256,171,7256,171,0,206
"Cache County, Utah",136649,655,43729,649,41864,1128,1865,892,79503,1072,72540,1850,6963,1565,13417,566,13412,568,5,10
"Carbon County, Utah",20234,178,5399,310,5351,310,48,80,10906,443,9849,596,1057,400,3929,350,3929,350,0,206
"Davis County, Utah",362710,1615,117960,862,109329,4466,8631,4293,206247,1668,189409,2738,16838,2530,38503,585,38345,612,158,162
"Duchesne County, Utah",19927,1523,6339,1071,5499,1074,840,629,11326,911,8666,1018,2660,1004,2262,508,2262,508,0,206
"Iron County, Utah",60192,313,17152,1350,15973,1639,1179,1089,35002,1320,31162,1741,3840,1301,8038,456,8038,456,0,206
"Salt Lake County, Utah",1178523,3261,321229,1719,292210,5961,29019,5340,720951,3324,634137,6636,86814,6029,136343,1027,135078,1149,1265,528
"Sanpete County, Utah",27279,1160,8026,427,7743,466,283,228,15193,1140,13179,997,2014,776,4060,128,4060,128,0,206
"Sevier County, Utah",21738,189,6727,352,6629,367,98,108,11347,320,9575,499,1772,479,3664,167,3664,167,0,206
"Summit County, Utah",43019,128,10639,389,10402,462,237,318,26207,406,24494,621,1713,537,6173,158,6173,158,0,206
"Tooele County, Utah",76145,489,25068,478,23805,1152,1263,1051,43845,715,40677,1361,3168,1248,7232,238,7232,238,0,206
"Uintah County, Utah",35958,503,12035,1003,10919,1137,1116,657,19551,1137,16353,1628,3198,1048,4372,490,4372,490,0,206
"Utah County, Utah",681572,1441,235233,1516,220504,3587,14729,3403,392999,1554,353751,4753,39248,4518,53340,630,53061,694,279,241
"Wasatch County, Utah",35706,518,12017,1738,11388,1943,629,592,18841,1298,16707,1463,2134,963,4848,948,4835,949,13,26
"Washington County, Utah",189056,1536,49896,1793,40969,3425,8927,3268,97660,2452,81552,3524,16108,2988,41500,903,41321,936,179,223
"Weber County, Utah",263494,1916,75719,775,69482,1908,6237,1959,155597,2022,137389,3165,18208,3030,32178,476,31849,534,329,322
"Addison County, Vermont",37048,250,7046,533,7032,535,14,24,21973,551,20851,594,1122,410,8029,278,8029,278,0,165
"Bennington County, Vermont",37046,275,7216,358,7192,358,24,39,21297,436,19780,793,1517,721,8533,351,8523,351,10,16
"Caledonia County, Vermont",30169,326,6282,434,6225,444,57,73,17227,505,15573,723,1654,707,6660,265,6660,265,0,165
"Chittenden County, Vermont",167339,454,33020,1096,31893,1185,1127,642,107547,1225,103252,1773,4295,1439,26772,445,26640,440,132,192
"Franklin County, Vermont",49877,293,11442,213,10967,474,475,484,30165,402,28761,749,1404,658,8270,221,8270,221,0,165
"Lamoille County, Vermont",25983,184,5174,584,5052,612,122,207,16251,607,13649,1079,2602,1134,4558,216,4537,217,21,37
"Orange County, Vermont",29371,233,5907,391,5848,429,59,112,16882,363,16045,588,837,381,6582,168,6582,168,0,165
"Orleans County, Vermont",26946,252,5416,303,5416,303,0,165,15334,307,14410,413,924,334,6196,178,6196,178,0,165
"Rutland County, Vermont",60173,440,11641,568,11600,566,41,61,34721,532,32986,875,1735,655,13811,474,13811,474,0,165
"Washington County, Vermont",58966,603,11118,284,11033,294,85,92,35732,560,34745,669,987,462,12116,389,12116,389,0,165
"Windham County, Vermont",45655,348,8352,524,8341,514,11,30,26032,482,24197,725,1835,620,11271,276,11233,278,38,63
"Windsor County, Vermont",57309,405,10866,502,10545,573,321,267,32403,580,30929,870,1474,660,14040,296,14029,296,11,19
"Accomack County, Virginia",32875,320,7213,341,6680,770,533,665,16930,631,14229,1060,2701,971,8732,451,8708,450,24,53
"Albemarle County, Virginia",112193,790,27328,1259,25811,1604,1517,1006,62766,1591,57799,2095,4967,1426,22099,556,22099,556,0,216
"Amherst County, Virginia",31078,242,6742,319,6600,355,142,168,17776,521,15786,864,1990,792,6560,525,6560,525,0,216
"Arlington County, Virginia",228054,1230,43119,534,41325,1294,1794,1140,157791,1658,148662,3046,9129,2459,27144,1055,25849,694,1295,924
"Augusta County, Virginia",75145,827,16750,1025,15170,1341,1580,947,41925,1249,36482,2114,5443,1854,16470,231,16470,231,0,216
"Bedford County, Virginia",79833,216,16443,756,16113,797,330,246,45530,915,41335,2091,4195,1653,17860,535,17860,535,0,216
"Botetourt County, Virginia",33525,268,6634,281,6328,434,306,359,19199,322,17353,801,1846,771,7692,139,7692,139,0,216
"Campbell County, Virginia",55010,406,11720,489,11265,604,455,368,32648,805,30481,1107,2167,830,10642,534,10642,534,0,216
"Caroline County, Virginia",29254,1148,6671,1092,6619,1102,52,124,16657,1056,13834,1200,2823,946,5926,890,5926,890,0,216
"Carroll County, Virginia",28920,132,5418,1076,5213,1200,205,334,16739,1105,14230,1165,2509,1142,6763,1071,6763,1071,0,216
"Chesterfield County, Virginia",367702,1168,92868,1135,87351,2009,5517,1789,216777,1690,196883,3338,19894,3414,58057,904,57645,994,412,353
"Culpeper County, Virginia",52145,620,13185,371,12612,426,573,451,30781,728,26760,1649,4021,1474,8179,539,8179,539,0,216
"Dinwiddie County, Virginia",26998,781,6846,806,6799,818,47,60,15349,1377,14213,1343,1136,648,4803,1032,4803,1032,0,216
"Fairfax County, Virginia",1125337,1951,279033,1445,264958,2884,14075,2826,682290,2365,621354,6048,60936,5724,164014,477,159894,1535,4120,1418
"Fauquier County, Virginia",73605,207,17125,784,16559,896,566,577,44075,865,39475,1400,4600,1044,12405,485,12382,489,23,38
"Fluvanna County, Virginia",27514,2576,5884,1490,5649,1445,235,390,16704,1652,14583,1749,2121,985,4926,1083,4926,1083,0,216
"Franklin County, Virginia",54510,368,9952,552,9711,568,241,302,31114,768,27986,1151,3128,848,13444,409,13444,409,0,216
"Frederick County, Virginia",91658,1387,22343,480,21205,713,1138,758,52460,1501,45704,1885,6756,1848,16855,552,16855,552,0,216
"Gloucester County, Virginia",38495,387,8306,628,8279,618,27,49,22235,748,20584,1019,1651,773,7954,170,7954,170,0,216
"Goochland County, Virginia",24651,259,4859,946,4736,964,123,214,14277,1198,13187,1381,1090,724,5515,1246,5515,1246,0,216
"Halifax County, Virginia",32879,687,7322,440,6893,621,429,423,17025,809,15164,1159,1861,943,8532,424,8457,432,75,89
"Hanover County, Virginia",110350,1130,25319,503,24386,740,933,527,63661,1328,59639,1693,4022,1248,21370,651,21195,647,175,209
"Henrico County, Virginia",331329,943,78004,706,75459,1474,2545,1335,199338,1305,182752,2449,16586,2362,53987,567,53467,707,520,403
"Henry County, Virginia",48877,962,9997,271,9839,359,158,218,26526,982,22546,1363,3980,1209,12354,277,12354,277,0,216
"Isle of Wight County, Virginia",38525,373,8725,280,8474,340,251,225,22192,580,21348,738,844,428,7608,367,7608,367,0,216
"James City County, Virginia",77994,978,16714,736,16385,789,329,378,40212,1283,37762,1605,2450,921,21068,628,21068,628,0,216
"King George County, Virginia",26993,436,7113,1084,6736,984,377,478,16397,1115,15967,1107,430,322,3483,798,3483,798,0,216
"Lee County, Virginia",20235,773,4607,1004,4607,1004,0,216,9937,941,8681,1232,1256,838,5691,1055,5611,1040,80,150
"Loudoun County, Virginia",425659,890,121792,1002,116588,2049,5204,1639,260841,1239,242117,4163,18724,3901,43026,209,41988,480,1038,480
"Louisa County, Virginia",38754,173,8018,1443,7883,1423,135,142,22423,1671,20676,1685,1747,716,8313,1566,8313,1566,0,216
"Mecklenburg County, Virginia",29602,432,5643,170,5477,171,166,195,16235,345,14395,724,1840,645,7724,197,7518,256,206,184
"Montgomery County, Virginia",97868,359,18856,1016,18856,1016,0,216,65770,1117,62198,2039,3572,1465,13242,329,13242,329,0,216
"New Kent County, Virginia",23628,2285,5750,1174,5750,1174,0,216,13667,1650,13432,1645,235,285,4211,898,4211,898,0,216
"Orange County, Virginia",36490,944,7578,286,7578,286,0,216,21092,1018,19552,1395,1540,888,7820,410,7820,410,0,216
"Page County, Virginia",23633,241,5262,345,5209,335,53,102,13333,418,11103,874,2230,811,5038,224,5038,224,0,216
"Pittsylvania County, Virginia",58729,700,11637,439,11243,492,394,290,32881,734,30137,1143,2744,941,14211,203,14211,203,0,216
"Powhatan County, Virginia",29825,322,5640,811,5342,765,298,402,17415,1225,16244,1473,1171,834,6770,1212,6770,1212,0,216
"Prince Edward County, Virginia",21067,536,5921,892,5867,912,54,104,12209,950,11303,1015,906,629,2937,757,2937,757,0,216
"Prince George County, Virginia",35050,2625,10477,1157,10218,1181,259,323,18732,2171,18179,2143,553,472,5841,938,5841,938,0,216
"Prince William County, Virginia",474157,2542,135338,991,127247,2334,8091,2056,286579,2565,250131,4544,36448,3957,52240,320,51061,603,1179,536
"Pulaski County, Virginia",32391,2181,6128,193,5842,351,286,311,18678,1975,16514,1797,2164,942,7585,300,7585,300,0,216
"Roanoke County, Virginia",94192,1046,20099,501,19686,690,413,464,52604,1216,49468,1528,3136,1069,21489,686,21315,591,174,240
"Rockbridge County, Virginia",22342,324,4857,972,4443,1016,414,482,12284,978,11123,1391,1161,894,5201,1026,5201,1026,0,216
"Rockingham County, Virginia",84108,307,19133,348,17738,759,1395,690,48548,457,40978,1939,7570,1920,16427,446,16311,460,116,144
"Russell County, Virginia",25323,217,4618,1037,4576,1038,42,73,15790,764,15397,815,393,350,4915,1042,4915,1042,0,216
"Scott County, Virginia",20416,1511,4401,948,4259,949,142,177,11364,1627,9370,1386,1994,1023,4651,801,4612,798,39,72
"Shenandoah County, Virginia",44471,131,10068,466,9948,513,120,185,24651,525,22507,956,2144,834,9752,340,9752,340,0,216
"Smyth County, Virginia",29087,286,5923,315,5692,417,231,245,16777,385,14669,803,2108,796,6387,96,6351,120,36,63
"Spotsylvania County, Virginia",142664,481,37480,615,35665,1330,1815,1230,83874,954,75994,2023,7880,1758,21310,487,21151,472,159,160
"Stafford County, Virginia",153856,1597,44912,844,44088,1014,824,514,92189,1833,87212,2167,4977,1495,16755,463,16546,559,209,318
"Tazewell County, Virginia",38946,485,8462,1084,8249,1100,213,249,20734,612,18609,1106,2125,927,9750,839,9750,839,0,216
"Warren County, Virginia",40821,91,9567,705,8290,1008,1277,957,24426,666,20864,1319,3562,1218,6828,397,6777,397,51,84
"Washington County, Virginia",52586,1766,9544,382,9484,389,60,105,29975,1294,27329,1297,2646,945,13067,430,13067,430,0,216
"Wise County, Virginia",33525,890,7116,501,6751,306,365,487,19915,740,17971,819,1944,581,6494,253,6494,253,0,216
"Wythe County, Virginia",30483,2084,6967,880,6902,903,65,106,16691,1732,15756,1748,935,506,6825,733,6825,733,0,216
"York County, Virginia",66873,1063,17135,583,16883,649,252,297,37452,1472,35949,1574,1503,634,12286,891,12219,903,67,115
"Alexandria city, Virginia",151727,1237,29387,579,27456,1468,1931,1145,102817,1307,88495,2606,14322,2350,19523,758,19268,760,255,317
"Charlottesville city, Virginia",45463,276,7218,467,7218,467,0,216,32754,593,31064,769,1690,669,5491,465,5491,465,0,216
"Chesapeake city, Virginia",238720,2123,63413,719,61063,1183,2350,1021,140343,2288,124880,3808,15463,3299,34964,861,34917,846,47,81
"Danville city, Virginia",41259,620,10044,537,9746,632,298,353,22953,672,20101,1053,2852,878,8262,292,8240,294,22,38
"Fairfax city, Virginia",23997,301,4382,909,3615,897,767,586,15047,804,13318,1370,1729,1169,4568,1059,4568,1059,0,216
"Fredericksburg city, Virginia",28016,389,4931,1387,4261,1225,670,879,19108,1442,15471,1902,3637,1204,3977,1089,3977,1089,0,216
"Hampton city, Virginia",130486,1361,31350,727,30595,805,755,569,78178,1300,70756,2107,7422,1906,20958,404,20895,419,63,113
"Harrisonburg city, Virginia",50806,774,12150,1039,11421,1049,729,394,34170,1284,31484,1513,2686,824,4486,290,4454,294,32,60
"Hopewell city, Virginia",21048,3133,5037,1602,4737,1562,300,322,12829,1949,11571,1749,1258,774,3182,852,3182,852,0,216
"Lynchburg city, Virginia",77395,1107,17882,947,17365,962,517,378,48503,1397,44946,1660,3557,954,11010,527,11010,527,0,216
"Manassas city, Virginia",42579,206,12354,1395,10830,1624,1524,1062,26290,1398,18983,2220,7307,1775,3935,972,3892,969,43,76
"Newport News city, Virginia",174157,1987,46252,921,45396,1065,856,596,103179,2203,92320,2965,10859,1920,24726,401,24541,422,185,166
"Norfolk city, Virginia",202736,3138,49416,1107,46127,1783,3289,1351,126330,3104,111040,3342,15290,2661,26990,442,26612,571,378,327
"Petersburg city, Virginia",32919,334,7053,497,6853,537,200,220,19853,590,17330,1272,2523,1206,6013,205,6013,205,0,216
"Portsmouth city, Virginia",91485,1631,23560,672,22798,762,762,412,52884,1469,49321,1693,3563,1272,15041,509,15041,509,0,216
"Richmond city, Virginia",224206,1243,41466,888,40253,1073,1213,704,151137,1437,136077,2965,15060,2615,31603,713,31386,707,217,214
"Roanoke city, Virginia",97401,918,23107,477,21705,909,1402,873,57750,1131,50257,2034,7493,1688,16544,565,16175,496,369,338
"Salem city, Virginia",24583,430,5619,1234,5574,1224,45,83,14527,1171,12946,1261,1581,574,4437,850,4437,850,0,216
"Staunton city, Virginia",24963,728,4904,1127,4904,1127,0,216,14786,1123,13655,1206,1131,657,5273,935,5273,935,0,216
"Suffolk city, Virginia",92187,1625,23755,552,23068,703,687,419,54101,1701,50840,1964,3261,1098,14331,116,14331,116,0,216
"Virginia Beach city, Virginia",431334,2926,105880,1061,101973,1926,3907,1519,257034,2961,235232,3778,21802,2991,68420,480,68223,493,197,196
"Waynesboro city, Virginia",22233,359,4468,930,4451,923,17,53,14463,1106,12208,1277,2255,1140,3302,934,3302,934,0,216
"Winchester city, Virginia",27894,221,8573,1629,7542,1886,1031,1095,16112,1420,14614,1696,1498,801,3209,993,3157,979,52,96
"Asotin County, Washington",22140,247,4324,1259,4149,1246,175,290,11949,1228,10175,1194,1774,1076,5867,1136,5867,1136,0,213
"Benton County, Washington",208812,757,57741,1171,56111,1573,1630,1058,118298,1474,102374,2562,15924,2290,32773,628,32694,639,79,100
"Chelan County, Washington",79146,632,18581,251,17965,592,616,526,43934,876,35468,2575,8466,2282,16631,777,16555,790,76,115
"Clallam County, Washington",77172,526,13598,400,13183,577,415,386,39320,748,34189,1439,5131,1240,24254,608,24188,609,66,117
"Clark County, Washington",508620,1176,122975,1036,119534,1534,3441,1252,303038,1607,272861,3723,30177,3721,82607,831,82059,884,548,414
"Cowlitz County, Washington",110808,490,26792,899,25587,1252,1205,773,62712,979,56199,1411,6513,1388,21304,446,21081,440,223,222
"Douglas County, Washington",43600,161,11686,400,11490,448,196,234,24566,412,19306,1292,5260,1152,7348,288,7268,228,80,147
"Franklin County, Washington",96153,981,32075,1288,31822,1309,253,283,55773,1637,46567,2900,9206,2703,8305,784,8175,806,130,231
"Grant County, Washington",99853,259,29295,499,28683,730,612,480,57559,952,44587,2424,12972,2623,12999,794,12999,794,0,213
"Grays Harbor County, Washington",73159,1017,15939,436,15614,554,325,289,40054,986,36157,1389,3897,1264,17166,462,17158,460,8,14
"Island County, Washington",79160,2752,16593,789,15756,867,837,630,40646,2350,38308,2304,2338,691,21921,268,21883,249,38,72
"Jefferson County, Washington",33186,363,4688,618,4652,613,36,75,15413,699,14633,749,780,488,13085,495,12906,564,179,275
"King County, Washington",2238712,2095,471749,1936,457976,3450,13773,3148,1463304,2989,1362661,7880,100643,7362,303659,892,300709,1382,2950,967
"Kitsap County, Washington",260236,1886,57040,650,55222,866,1818,834,150818,1990,137791,2885,13027,2553,52378,510,52068,568,310,237
"Kittitas County, Washington",45179,358,8629,946,8483,946,146,201,29133,982,26029,1656,3104,1273,7417,254,7417,254,0,213
"Klickitat County, Washington",23082,69,5351,1315,5307,1322,44,75,12447,1263,10851,1563,1596,792,5284,1227,5284,1227,0,213
"Lewis County, Washington",83592,541,19005,764,18439,944,566,441,47272,703,41470,1546,5802,1279,17315,427,17260,419,55,78
"Mason County, Washington",66867,516,13820,567,13529,622,291,248,37540,771,32832,1296,4708,1221,15507,393,15502,393,5,10
"Okanogan County, Washington",42211,337,10234,428,9800,526,434,297,22390,610,18070,1151,4320,1080,9587,299,9189,482,398,414
"Pacific County, Washington",23689,289,4109,675,4109,675,0,213,12167,730,10593,818,1574,775,7413,182,7413,182,0,213
"Pierce County, Washington",896180,4183,224356,1179,215489,2943,8867,2590,540424,4350,494225,5802,46199,4773,131400,559,129643,956,1757,911
"Skagit County, Washington",129227,679,29109,488,28394,582,715,446,71586,995,64841,1812,6745,1566,28532,531,28093,538,439,397
"Snohomish County, Washington",824118,2039,193814,1149,189116,1761,4698,1414,511985,2423,470797,5430,41188,4760,118319,527,116804,840,1515,728
"Spokane County, Washington",535296,1742,126570,932,123423,1596,3147,1175,319147,1855,297853,3608,21294,2830,89579,854,89406,848,173,177
"Stevens County, Washington",47222,152,10650,367,10262,542,388,438,25072,444,22702,1058,2370,809,11500,260,11451,244,49,80
"Thurston County, Washington",289504,2101,66349,793,64754,1075,1595,819,169759,2226,157332,3022,12427,2756,53396,968,53396,968,0,213
"Walla Walla County, Washington",58786,1175,13127,1323,13127,1323,0,213,34288,1541,30351,1908,3937,1363,11371,675,11333,674,38,88
"Whatcom County, Washington",227300,725,47260,885,46010,927,1250,833,138067,1355,127014,3104,11053,2594,41973,885,41728,809,245,295
"Whitman County, Washington",47580,307,10435,1554,9829,1453,606,591,31958,1438,29394,1670,2564,1125,5187,350,5187,350,0,213
"Yakima County, Washington",253613,1080,79046,1071,73745,2335,5301,2117,139305,1632,108301,3338,31004,3689,35262,458,34715,711,547,560
"Berkeley County, West Virginia",125344,772,29669,745,29126,713,543,398,77013,1178,72211,1855,4802,1686,18662,751,18662,751,0,216
"Boone County, West Virginia",21198,183,4609,1012,4563,1009,46,79,12372,1095,11629,1136,743,483,4217,866,4217,866,0,216
"Brooke County, West Virginia",20224,2890,4099,1414,3725,1376,374,464,11152,2031,10033,1847,1119,719,4973,1064,4973,1064,0,216
"Cabell County, West Virginia",91707,823,20525,796,19685,1305,840,876,54491,1014,48716,1548,5775,1300,16691,790,16691,790,0,216
"Fayette County, West Virginia",38812,354,7424,72,6810,647,614,638,22474,661,18782,1744,3692,1593,8914,577,8739,616,175,248
"Greenbrier County, West Virginia",32153,263,6490,275,6448,285,42,74,18157,400,16623,681,1534,676,7506,314,7506,314,0,216
"Hampshire County, West Virginia",20281,2554,4613,1406,4455,1393,158,247,10263,1695,9805,1754,458,353,5405,929,5405,929,0,216
"Hancock County, West Virginia",28470,224,5335,135,5037,311,298,292,16294,232,13985,947,2309,945,6841,202,6841,202,0,216
"Harrison County, West Virginia",64503,261,14418,337,13606,720,812,657,37839,324,33309,1472,4530,1487,12246,291,12130,265,116,182
"Jackson County, West Virginia",27620,130,6925,944,6857,951,68,104,15365,1341,13346,1399,2019,1147,5330,1369,5048,1393,282,418
"Jefferson County, West Virginia",58186,136,13339,308,12661,675,678,590,35317,479,31699,1338,3618,1288,9530,373,9530,373,0,216
"Kanawha County, West Virginia",175841,941,37598,575,36866,872,732,674,100264,1067,94375,1667,5889,1344,37979,361,37979,361,0,216
"Lincoln County, West Virginia",20072,115,5980,1232,5636,1217,344,434,8983,1079,8168,1205,815,628,5109,1081,5109,1081,0,216
"Logan County, West Virginia",31384,696,6999,536,6961,526,38,57,17439,873,16280,968,1159,687,6946,372,6946,372,0,216
"Marion County, West Virginia",55699,215,11607,275,11127,474,480,386,33485,319,29381,1501,4104,1486,10607,239,10607,239,0,216
"Marshall County, West Virginia",29464,996,5879,158,5879,158,0,216,16631,957,15488,1122,1143,583,6954,222,6954,222,0,216
"Mason County, West Virginia",24704,449,4111,920,3954,961,157,265,14650,1463,12937,1560,1713,792,5943,1368,5943,1368,0,216
"Mercer County, West Virginia",58700,306,12699,296,11312,1209,1387,1139,32673,470,29303,1269,3370,1280,13328,312,13328,312,0,216
"Mineral County, West Virginia",26650,232,5743,398,5736,396,7,16,14982,450,13505,949,1477,765,5925,312,5925,312,0,216
"Mingo County, West Virginia",22944,129,4089,991,4043,988,46,79,14993,1238,13467,1418,1526,762,3862,1039,3862,1039,0,216
"Monongalia County, West Virginia",105421,739,20659,1263,20512,1360,147,238,70746,1302,65910,1858,4836,1476,14016,565,14016,565,0,216
"Nicholas County, West Virginia",24128,140,4508,925,4508,925,0,216,13409,986,12947,1073,462,560,6211,1159,6211,1159,0,216
"Ohio County, West Virginia",41389,370,9064,529,9045,529,19,38,23018,513,22297,566,721,379,9307,257,9307,257,0,216
"Preston County, West Virginia",31651,921,6627,99,6566,129,61,84,17916,851,15517,1084,2399,905,7108,194,7108,194,0,216
"Putnam County, West Virginia",56896,307,13490,878,12666,1339,824,906,31939,808,29992,1086,1947,1039,11467,735,11467,735,0,216
"Raleigh County, West Virginia",71963,596,16732,650,16360,742,372,449,39273,883,37264,1141,2009,879,15958,408,15958,408,0,216
"Randolph County, West Virginia",26314,578,5433,319,5433,319,0,216,14851,579,13048,1373,1803,1290,6030,213,6030,213,0,216
"Upshur County, West Virginia",23464,294,5167,1090,5167,1090,0,216,13139,1232,11786,1289,1353,665,5158,1196,5158,1196,0,216
"Wayne County, West Virginia",38408,145,8367,459,7894,617,473,406,21752,452,19328,1184,2424,1121,8289,123,8289,123,0,216
"Wood County, West Virginia",82994,471,18596,566,18141,631,455,361,47195,723,43834,1235,3361,993,17203,261,17203,261,0,216
"Wyoming County, West Virginia",21000,90,5131,1007,5131,1007,0,216,10619,811,9255,1272,1364,939,5250,925,5250,925,0,216
"Adams County, Wisconsin",19733,967,2818,284,2801,285,17,29,10552,788,9556,657,996,420,6363,192,6363,192,0,157
"Barron County, Wisconsin",46238,389,10391,173,9653,455,738,436,25557,454,22717,840,2840,771,10290,218,10290,218,0,157
"Brown County, Wisconsin",266256,1758,66956,863,63305,2241,3651,2260,157624,2036,146243,2705,11381,2210,41676,633,41488,663,188,309
"Calumet County, Wisconsin",52437,108,12441,239,12083,415,358,354,31432,304,30183,696,1249,624,8564,109,8564,109,0,157
"Chippewa County, Wisconsin",64669,1009,15147,560,14367,756,780,549,36677,848,34278,1123,2399,827,12845,610,12831,611,14,23
"Clark County, Wisconsin",34232,338,10781,163,7042,809,3739,790,17860,312,14206,606,3654,564,5591,195,5479,200,112,81
"Columbia County, Wisconsin",57180,924,12864,473,12250,594,614,359,33485,654,31728,1000,1757,697,10831,280,10822,281,9,15
"Dane County, Wisconsin",560075,1506,123230,1840,119918,1999,3312,1577,356041,2640,336541,3915,19500,2899,80804,711,80731,701,73,119
"Dodge County, Wisconsin",85777,1534,19425,983,18939,962,486,341,50411,1031,47854,1005,2557,668,15941,566,15794,525,147,192
"Door County, Wisconsin",30195,178,4595,400,4542,380,53,71,16000,365,15233,468,767,302,9600,343,9587,338,13,22
"Douglas County, Wisconsin",43663,460,9142,471,9086,474,56,75,26179,566,24331,724,1848,595,8342,223,8273,255,69,112
"Dunn County, Wisconsin",45068,302,9577,505,9332,531,245,192,28411,600,26578,786,1833,503,7080,203,7074,204,6,10
"Eau Claire County, Wisconsin",106027,360,23392,671,22320,857,1072,517,65227,803,60746,1408,4481,1120,17408,460,17378,466,30,49
"Fond du Lac County, Wisconsin",102870,794,23182,391,22560,647,622,538,60461,830,56234,1314,4227,1204,19227,213,19217,214,10,17
"Grant County, Wisconsin",51061,550,13224,409,11452,845,1772,712,28962,360,26195,859,2767,782,8875,180,8784,187,91,68
"Green County, Wisconsin",36762,161,8291,185,7926,364,365,297,21235,283,20341,466,894,373,7236,100,7236,100,0,157
"Iowa County, Wisconsin",23616,126,5341,193,5130,233,211,158,13600,200,12873,318,727,254,4675,113,4675,113,0,157
"Jackson County, Wisconsin",20203,640,4693,194,4314,303,379,220,11502,586,10469,595,1033,336,4008,125,4008,125,0,157
"Jefferson County, Wisconsin",84629,384,18309,631,17463,1038,846,913,50886,706,46458,1417,4428,1408,15434,397,15434,397,0,157
"Juneau County, Wisconsin",25778,786,5495,129,5243,226,252,157,14764,695,13187,908,1577,895,5519,297,5449,392,70,144
"Kenosha County, Wisconsin",167285,878,39685,718,39168,926,517,443,102984,1133,95178,1672,7806,1598,24616,522,24547,547,69,115
"Kewaunee County, Wisconsin",20468,73,4469,252,4413,256,56,54,11465,190,10793,259,672,233,4534,286,4521,286,13,22
"La Crosse County, Wisconsin",119296,797,26617,882,25449,1026,1168,619,72500,1153,67130,1587,5370,1487,20179,376,20179,376,0,157
"Lincoln County, Wisconsin",28196,296,5487,312,5228,310,259,177,16410,302,15054,571,1356,559,6299,256,6299,256,0,157
"Manitowoc County, Wisconsin",80575,709,17246,363,16399,656,847,572,46069,692,43106,1123,2963,859,17260,332,17229,335,31,42
"Marathon County, Wisconsin",136343,1199,32805,250,30798,657,2007,647,78468,1126,72479,1829,5989,1553,25070,671,25035,670,35,55
"Marinette County, Wisconsin",41309,405,8425,245,8276,251,149,113,22897,334,20983,609,1914,524,9987,191,9987,191,0,157
"Milwaukee County, Wisconsin",919488,1531,233847,1476,227401,2438,6446,1789,556043,1898,497853,4273,58190,4087,129598,591,128067,788,1531,605
"Monroe County, Wisconsin",44980,525,11812,261,10058,694,1754,624,25190,580,22183,923,3007,815,7978,248,7967,248,11,20
"Oconto County, Wisconsin",39049,328,8093,238,7956,268,137,112,22506,408,21323,546,1183,367,8450,152,8376,195,74,122
"Oneida County, Wisconsin",37717,453,6621,249,6534,225,87,100,20847,507,19408,720,1439,500,10249,238,10239,237,10,18
"Outagamie County, Wisconsin",190001,1259,46426,563,45143,1001,1283,837,114209,1174,109348,1876,4861,1379,29366,542,29366,542,0,157
"Ozaukee County, Wisconsin",92050,441,20821,558,20580,568,241,274,51890,899,50458,1020,1432,594,19339,538,19294,528,45,80
"Pierce County, Wisconsin",42200,190,9052,316,8910,330,142,115,26518,407,24940,709,1578,605,6630,226,6630,226,0,157
"Polk County, Wisconsin",44974,263,9645,335,9332,399,313,202,25484,378,23853,593,1631,457,9845,201,9761,229,84,80
"Portage County, Wisconsin",70310,147,14468,686,14093,752,375,300,43295,719,41064,928,2231,717,12547,305,12547,305,0,157
"Racine County, Wisconsin",192384,1090,46654,658,45701,1220,953,1059,112170,1153,101829,2194,10341,2050,33560,758,33272,856,288,382
"Rock County, Wisconsin",163209,454,40200,818,38983,1182,1217,736,95994,1056,88419,1719,7575,1416,27015,415,27015,415,0,157
"St. Croix County, Wisconsin",94357,474,24142,240,23573,422,569,343,55925,458,53349,775,2576,696,14290,242,14290,242,0,157
"Sauk County, Wisconsin",64925,460,15470,378,14414,736,1056,531,37052,509,34396,703,2656,620,12403,219,12263,247,140,110
"Shawano County, Wisconsin",40227,486,8881,213,8345,388,536,308,22758,457,21111,565,1647,468,8588,130,8524,159,64,90
"Sheboygan County, Wisconsin",115500,686,26907,443,26660,535,247,253,66817,822,62502,1331,4315,1191,21776,363,21762,366,14,25
"Taylor County, Wisconsin",19765,143,4799,106,4222,281,577,286,11053,142,9992,363,1061,316,3913,116,3913,116,0,157
"Trempealeau County, Wisconsin",30384,208,8115,121,7652,419,463,403,16831,134,15198,366,1633,356,5438,205,5399,208,39,57
"Vernon County, Wisconsin",30581,274,8665,221,6258,824,2407,789,15850,236,13826,629,2024,587,6066,150,5888,190,178,130
"Vilas County, Wisconsin",23286,348,3715,93,3714,92,1,3,12233,415,11040,564,1193,435,7338,251,7337,250,1,4
"Walworth County, Wisconsin",106151,385,24104,724,23058,979,1046,635,61634,691,57707,1266,3927,1106,20413,386,20398,387,15,25
"Washington County, Wisconsin",136539,547,29708,367,28247,1155,1461,1095,81296,584,76704,1435,4592,1399,25535,246,25535,246,0,157
"Waukesha County, Wisconsin",405915,1262,91604,926,89498,1311,2106,864,235315,1500,224877,2580,10438,1953,78996,890,78955,885,41,67
"Waupaca County, Wisconsin",50178,905,10804,285,10532,315,272,190,29418,851,27155,953,2263,640,9956,386,9956,386,0,157
"Waushara County, Wisconsin",23916,534,4736,204,3916,483,820,487,13020,432,11637,680,1383,496,6160,145,6129,149,31,37
"Winnebago County, Wisconsin",167922,991,37623,610,36744,857,879,559,101771,1272,95205,1650,6566,1336,28528,401,28440,405,88,145
"Wood County, Wisconsin",73501,274,16320,311,16018,449,302,292,41902,438,38939,834,2963,801,15279,195,15279,195,0,157
"Albany County, Wyoming",37521,116,6125,445,5736,613,389,429,25958,441,23965,726,1993,684,5438,335,5438,335,0,208
"Campbell County, Wyoming",45977,434,12651,350,10966,863,1685,778,27720,605,22457,1990,5263,1842,5606,381,5606,381,0,208
"Fremont County, Wyoming",38741,415,10567,351,8082,927,2485,887,20854,494,14383,1131,6471,1132,7320,111,7302,107,18,30
"Laramie County, Wyoming",97847,841,23640,784,20191,1699,3449,1460,57330,1159,50150,1902,7180,1722,16877,483,16877,483,0,208
"Lincoln County, Wyoming",20084,68,6237,866,4597,1120,1640,1131,10391,819,8640,898,1751,649,3456,739,3456,739,0,208
"Natrona County, Wyoming",78599,786,20102,653,19609,875,493,554,45362,1036,38334,1933,7028,1832,13135,461,13135,461,0,208
"Park County, Wyoming",29953,137,7080,1281,6603,1295,477,678,15906,1091,14679,1287,1227,740,6967,1213,6903,1217,64,104
"Sheridan County, Wyoming",31602,2478,8050,1169,7906,1237,144,250,16839,1578,13991,1863,2848,1189,6713,850,6713,850,0,208
"Sweetwater County, Wyoming",41373,237,10950,361,10086,729,864,625,25086,468,20430,1396,4656,1330,5337,223,5337,223,0,208
"Teton County, Wyoming",24572,2133,5499,1332,4050,1529,1449,1481,14159,1932,12712,2008,1447,906,4914,1452,4914,1452,0,208
"Uinta County, Wyoming",20458,184,5430,882,5364,871,66,94,11538,954,9014,1200,2524,1072,3490,812,3490,812,0,208
"Aguada Municipio, Puerto Rico",37945,30,6487,411,6412,447,75,117,23062,411,21728,886,1334,750,8396,30,8396,30,0,254
"Aguadilla Municipio, Puerto Rico",53808,235,9952,417,9529,639,423,451,31073,457,28404,1324,2669,1212,12783,108,12158,594,625,614
"Aguas Buenas Municipio, Puerto Rico",24023,179,3541,1246,3541,1246,0,254,15793,1301,15562,1284,231,226,4689,1162,4609,1168,80,133
"Aibonito Municipio, Puerto Rico",24423,29,4224,1200,4224,1200,0,254,15376,1074,15137,1132,239,327,4823,1233,4823,1233,0,254
"Añasco Municipio, Puerto Rico",23319,2375,4097,1060,3984,1085,113,199,13016,1902,11763,1811,1253,1012,6206,978,6206,978,0,254
"Arecibo Municipio, Puerto Rico",86185,322,14933,597,14369,919,564,716,50984,564,47906,1314,3078,1093,20268,193,19937,423,331,375
"Barceloneta Municipio, Puerto Rico",22821,1,3701,923,3701,923,0,254,13090,1271,12126,1350,964,908,6030,1256,6030,1256,0,254
"Barranquitas Municipio, Puerto Rico",28849,257,6279,1451,6279,1451,0,254,15616,1495,15087,1566,529,411,6954,1439,6888,1413,66,108
"Bayamón Municipio, Puerto Rico",177429,857,31027,655,30647,728,380,308,103914,1186,94324,2137,9590,1956,42488,368,42283,406,205,179
"Cabo Rojo Municipio, Puerto Rico",47221,183,8059,504,8059,504,0,254,27695,504,25118,1136,2577,1109,11467,172,11124,380,343,354
"Caguas Municipio, Puerto Rico",126313,312,23382,1053,22806,1192,576,647,75340,1073,68840,2136,6500,1979,27591,312,27457,370,134,215
"Camuy Municipio, Puerto Rico",32682,102,6060,1115,6060,1115,0,254,19839,1324,17862,1798,1977,1122,6783,1199,6783,1199,0,254
"Canóvanas Municipio, Puerto Rico",42443,165,7753,237,7753,237,0,254,26661,278,23735,1172,2926,1129,8029,20,7761,319,268,318
"Carolina Municipio, Puerto Rico",151526,904,25521,445,25019,657,502,462,89556,980,79413,2388,10143,2177,36449,235,35969,443,480,392
"Cataño Municipio, Puerto Rico",22721,229,4158,270,4096,252,62,91,13258,365,11752,863,1506,868,5305,254,5287,31,18,31
"Cayey Municipio, Puerto Rico",41502,76,7231,531,7231,531,0,254,24760,531,22439,1160,2321,1075,9511,76,9511,76,0,254
"Cidra Municipio, Puerto Rico",39771,108,8521,1431,8296,1439,225,294,24087,1637,21366,1678,2721,1433,7163,1460,7163,1460,0,254
"Coamo Municipio, Puerto Rico",34794,181,6000,254,6000,254,0,254,21767,180,20539,729,1228,713,7027,10,6938,89,89,89
"Corozal Municipio, Puerto Rico",34311,164,7730,2275,7730,2275,0,254,19884,2055,18060,2190,1824,1105,6697,1244,6659,1244,38,65
"Dorado Municipio, Puerto Rico",36060,83,7825,1625,7825,1625,0,254,21076,1575,19299,1941,1777,1016,7159,1196,7159,1196,0,254
"Fajardo Municipio, Puerto Rico",29815,2838,5413,1288,5413,1288,0,254,17600,2407,16002,2380,1598,681,6802,1081,6740,1101,62,103
"Guayama Municipio, Puerto Rico",34540,628,4203,1916,4203,1916,0,254,21757,1780,20363,1748,1394,994,8580,1793,8580,1793,0,254
"Guaynabo Municipio, Puerto Rico",88613,366,13884,507,13840,519,44,75,52808,547,50938,1162,1870,965,21921,268,21674,460,247,391
"Gurabo Municipio, Puerto Rico",41151,330,7036,1572,6817,1588,219,346,27400,1512,26194,1787,1206,996,6715,1181,6383,1240,332,497
"Hatillo Municipio, Puerto Rico",38623,91,5967,1180,5876,1195,91,159,23573,1400,20075,1804,3498,1515,9083,1208,8705,1265,378,594
"Humacao Municipio, Puerto Rico",50389,358,9092,705,8787,716,305,350,28683,748,25923,1295,2760,1153,12614,254,12562,89,52,89
"Isabela Municipio, Puerto Rico",42649,136,7678,922,7678,922,0,254,25751,908,24882,1055,869,695,9220,118,9220,118,0,254
"Juana Díaz Municipio, Puerto Rico",46091,84,9263,520,9263,520,0,254,27609,524,25968,963,1641,752,9219,67,9219,67,0,254
"Juncos Municipio, Puerto Rico",37214,150,6188,1618,6188,1618,0,254,24133,1705,22457,1666,1676,1168,6893,1734,6893,1734,0,254
"Lajas Municipio, Puerto Rico",23106,95,3717,1151,3467,1179,250,373,13188,1048,12103,1326,1085,795,6201,1163,5915,1112,286,458
"Lares Municipio, Puerto Rico",26885,2813,4760,1090,4090,1108,670,852,16127,1864,14718,1932,1409,1038,5998,860,5998,860,0,254
"Las Piedras Municipio, Puerto Rico",35473,59,6475,1304,6319,1274,156,229,21366,1651,19581,1750,1785,779,7632,1617,7632,1617,0,254
"Loíza Municipio, Puerto Rico",23382,49,4395,198,4395,198,0,254,13934,189,11879,889,2055,856,5053,254,5053,254,0,254
"Manatí Municipio, Puerto Rico",38940,201,6924,239,6047,679,877,634,22633,264,19406,1311,3227,1300,9383,113,9294,181,89,145
"Mayagüez Municipio, Puerto Rico",71403,305,12896,1010,12896,1010,0,254,40188,1048,38840,1244,1348,645,18319,259,18297,261,22,37
"Moca Municipio, Puerto Rico",37263,165,7329,1477,7094,1480,235,386,21878,1760,20264,2094,1614,1020,8056,1609,7979,1616,77,122
"Morovis Municipio, Puerto Rico",28569,2478,5741,1255,5406,1173,335,368,17805,1561,16418,1792,1387,937,5023,767,5023,767,0,254
"Naguabo Municipio, Puerto Rico",23579,55,5654,1694,5654,1694,0,254,14416,1609,12706,1853,1710,1066,3509,1071,3509,1071,0,254
"Naranjito Municipio, Puerto Rico",28966,353,4995,1590,4763,1647,232,366,17274,1479,16585,1500,689,728,6697,1230,6697,1230,0,254
"Orocovis Municipio, Puerto Rico",21149,222,4621,1254,4621,1254,0,254,12773,1381,12092,1413,681,812,3755,1016,3755,1016,0,254
"Peñuelas Municipio, Puerto Rico",19041,2360,4173,1014,3937,947,236,346,11077,1715,10219,1710,858,625,3791,728,3791,728,0,254
"Ponce Municipio, Puerto Rico",132448,672,25154,458,23452,1169,1702,1184,74474,749,69476,1746,4998,1614,32820,330,32746,342,74,90
"Quebradillas Municipio, Puerto Rico",23558,1,4834,1359,4834,1359,0,254,13863,1387,12131,1544,1732,1027,4861,1223,4861,1223,0,254
"Río Grande Municipio, Puerto Rico",46316,257,8178,388,7792,520,386,303,27833,468,24096,1438,3737,1450,10305,34,10305,34,0,254
"Salinas Municipio, Puerto Rico",25564,225,4814,817,4343,818,471,557,15610,842,14032,1061,1578,849,5140,850,5140,850,0,254
"San Germán Municipio, Puerto Rico",29970,2728,5643,1153,5643,1153,0,254,16163,2053,15370,2188,793,579,8164,995,8164,995,0,254
"San Juan Municipio, Puerto Rico",333339,1401,57661,921,54623,1778,3038,1408,193558,1334,168167,3715,25391,3364,82120,882,79643,1840,2477,1552
"San Lorenzo Municipio, Puerto Rico",37340,246,7372,1790,6803,1704,569,860,20929,1797,18555,1708,2374,1070,9039,1075,8707,1115,332,519
"San Sebastián Municipio, Puerto Rico",38862,198,6568,1429,6534,1427,34,61,22724,1677,19882,1782,2842,1151,9570,1580,9570,1580,0,254
"Santa Isabel Municipio, Puerto Rico",20223,116,4553,1037,4497,1033,56,95,11716,979,10360,1171,1356,786,3954,850,3891,841,63,115
"Toa Alta Municipio, Puerto Rico",67337,323,13790,1128,13525,1022,265,419,42824,1128,40355,1999,2469,1295,10723,322,10513,394,210,231
"Toa Baja Municipio, Puerto Rico",73749,404,13242,446,13127,464,115,192,44771,582,41376,1188,3395,1025,15736,251,15688,281,48,81
"Trujillo Alto Municipio, Puerto Rico",66861,352,11784,274,11784,274,0,254,41020,279,37650,1307,3370,1247,14057,343,14057,343,0,254
"Utuado Municipio, Puerto Rico",30139,2445,5560,981,5390,989,170,302,17560,1671,17166,1664,394,338,7019,990,6971,1015,48,83
"Vega Alta Municipio, Puerto Rico",35015,366,7172,861,6939,889,233,264,21904,1279,20834,1495,1070,700,5939,1256,5898,1272,41,72
"Vega Baja Municipio, Puerto Rico",53756,315,9219,231,8554,564,665,528,32554,231,29303,1233,3251,1224,11983,313,11927,315,56,94
"Villalba Municipio, Puerto Rico",21701,208,4490,962,4490,962,0,254,12955,1151,12394,1225,561,455,4256,1135,4256,1135,0,254
"Yabucoa Municipio, Puerto Rico",29733,3155,4925,1675,4925,1675,0,254,16997,2557,15546,2519,1451,835,7811,1736,7788,1738,23,38
"Yauco Municipio, Puerto Rico",33503,236,5955,438,5955,438,0,254,19225,444,17741,870,1484,788,8323,222,8323,222,0,254